XXXXXXXXXXX
P X       X
X X XXXXX X
X     X   X
XXX XXX XXX
X       X X
XX XX XXX X
X       X X
X XXXXX X X
X X       K
XXXXXXXXXXX
