XXXXXXXXXXXXXXXXXXXXXXXXXXXXXXXXXXXXXXXXXXXXXXXXXXXXXXXXXXXXXXXXXXXXXXXXXXXXXXXXXXXXXXXXXXXXXXXXXXXXX
P   X           X X       X       X         X     X             X               X       X   X   X   X
X X X XXX XXXXX X X XXX XXX XXX X X XXXXXXX X X X XXXXXXX X XXX XXX XXXXXXXXXXX XXX X XXX X X X X X X
X X   X X X   X   X   X     X X X X       X   X X       X X   X   X     X   X   X   X X   X X X   X X
X XXXXX X X X XXXXXXX XXXXXXX X XXXXXXXXX XXXXX XXXXXXX X XXX XXX X XXX X XXX XXX X XXX XXX XXX XXX X
X       X   X       X     X   X   X       X   X     X X X   X X X X X   X     X   X X     X   X   X X
XXXXX XXXXXXXXXXX XXXXXXX XXX XXX X XXXXXXX X XXX X X X XXXXX X X XXX XXX XXXXXXX X X XXXXXXX X XXX X
X     X           X             X   X       X   X X X X   X   X X     X     X   X X X X       X X   X
XXXXXXX XXXXX XXXXX XXXXXXXXXXXXXXXXX XXXXXXXXX XXX X XXX X XXX X XXXXXXXXX X X X XXX X XXXXXXXXX X X
X       X   X X     X           X     X         X   X       X     X     X X X X X X   X     X     X X
X XXX XXX X X X XXXXX XXXXXXXXX X XXXXXXXXXXXXX X XXX XXXXXXX XXXXX XXX X X X X X X XXXXXXX XXX XXXXX
X X   X   X X X X   X     X     X   X   X     X X X   X   X     X X X X X X X X   X X X   X   X     X
X X XXX XXX XXX X X XXXXX XXX XXXXX X X X XXX X X X XXX X XXXXX X X X X X X X X XXX X X X XXX X XXX X
X X   X X X X   X X     X   X       X X   X X X   X   X X X   X   X   X X   X X X   X X X X   X   X X
X XXXXX X X X XXX X XXX XXX XXXXXXX X XXXXX X X XXXXXXX X X X XXXXXXX X X XXX X X XXX X X X XXXXXXX X
X       X X   X X X X   X X       X X X     X X X       X   X         X X X   X X X   X X X   X     X
X XXXXXXX XXXXX X X X XXX XXXXXXX XXX XXX X X XXX XXXXXXXXXXXXXXXXXXXXX X XXX X X XXX X X XXX X XXX X
X X   X   X       X X X     X   X   X     X X   X X           X         X     X X     X X X   X X   X
X X X X X XXXXXXXXX X X X X X XXXXX XXXXXXX XXX X XXXXXXX XXX X XXXXXXXXXXXXXXX XXXXX X X X XXX XXXXX
X X X   X     X     X X X X   X           X X   X         X   X X X         X     X   X X   X       X
X X XXXXXXXXX X XXXXX XXX XXX X XXXXX XXXXX X X XXXXXXXXX XXXXX X X X XXXXXXX XXXXX XXX XXXXX XXXXX X
X X X   X   X X X   X     X   X X   X X   X X X         X X     X X X         X     X X X   X     X X
X X X X X X X X X X XXXXX XXXXX X X X X X X X X XXXXXXXXX X XXXXX X XXXXXXXXXXX XXXXX X X X X XXXXX X
X   X X X X   X   X     X X     X X X X X   X X X         X     X   X     X   X       X X X   X     X
XXXXX XXX XXXXX XXXXXXX X X XXXXX X XXX XXXXX XXX XXXXXXXXXXXXX XXXXX XXX X X XXXXX XXX X XXXXX XXX X
X       X X   X X     X X X       X     X   X   X X         X   X     X X   X   X   X   X     X X   X
X XXXXX X X XXX X X XXX XXXXXXXXXXXXXXXXXXX XXX X X X XXXXXXX XXX XXXXX XXXXXXX X XXX XXXXXXXXX XXXXX
X     X X X X   X X X   X                 X   X X X X X     X X   X X         X X X   X       X X   X
XXXXX X X X X XXX X X XXX X XXXXXXXXXXXXX X X X X XXX X XXX X X XXX X XXXXXXX X X X XXX XXXXX X X X X
X   X X   X X   X X X     X   X     X   X   X X X     X   X   X X   X   X X   X   X X     X X X   X X
X XXX XXXXX XXX XXX XXXXXXXXX X X XXX X XXXXX X XXX XXXXX X XXX X X XXX X X X XXXXX XXXXX X X XXXXX X
X X   X X     X     X   X     X X X   X     X X X   X     X X   X X X     X X   X X   X   X X     X X
X X XXX X XXX XXXXX XXX X XXXXX XXX XXXXX X X X X XXX XXXXXXX XXX X X XXXXX XXX X XXX X XXX XXXXX X X
X X X       X           X X       X X   X X X X X X X       X X X X     X   X     X   X X   X   X   X
X X XXXXXXX XXXXXXXXXXX X XXXXXXX X XXX X XXX X X X XXXXXXX X X X XXXXXXX X XXXXXXX XXX X XXX X XXX X
X X     X     X   X     X     X   X   X X     X     X       X X X X X     X X       X   X     X   X X
X XXXXX X XXXXX X XXXXXXXXXXX X XXXXX X XXXXXXXXXXXXX XXX XXX X X X X XXXXXXX XXXXXXXXX XXXXXXXXX X X
X   X   X   X   X   X   X     X       X   X       X   X   X   X X   X X       X       X     X     X X
X XXX XXXXXXX XXXXX X X X X XXXXXXX XXX X X XXXXX X XXXXXXX XXX X XXX X XXXXXXX XXXXX X XXX X XXX X X
X     X       X X     X   X X     X X   X X   X   X       X X   X X   X       X X X   X X   X   X X X
X XXXXX XXXXXXX X XXXXXXXXX X XXX X XXX X XXX X XXXXXXXXX X X XXX X X XXXXXXX X X X XXX X XXXXX XXX X
X   X     X     X X   X   X X   X X   X X   X X         X   X     X X   X   X     X X   X     X X   X
XXX XXXXX X XXXXX X X X X X XXX X XXX X XXX XXXXXXX XXX XXXXX XXXXX XXX XXX XXXXXXX X XXXXXXX X X XXX
X X X   X X     X X X   X X   X X X   X   X X     X   X           X X X X       X   X X     X X X   X
X X X X X XXX X X X XXXXX XXXXX X X XXX X X X XXX X XXXXX XXXXXXXXX X X X X XXXXX XXX XXX X X X XXX X
X X   X X   X X   X X   X X     X X X   X X   X X X X   X X   X   X X X   X X     X X X   X X X     X
X XXXXX X X XXX XXX X X X X XXXXX X XXXXX XXXXX X XXX X X XXX X X X X XXX XXX XXXXX X X XXX X XXXXXXX
X X   X X X   X   X   X X   X     X       X   X       X X   X X X   X     X   X   X   X   X X       X
X X X X X XXX XXX XXXXX XXXXX XXXXXXXXX XXX X XXXXXXXXX XXX X X XXXXX XXXXX XXX XXX XXXXX X XXXXXXX X
X X X   X   X   X   X   X   X     X   X X   X   X     X   X X X X   X   X   X       X     X X       X
X X XXXXXXXXXXX XXXXX XXX X XXXXX X X XXX XXXXX XXX X XXX X X X X X X XXX XXXXXXX XXX XXXXX X XXXXX X
X X           X           X X   X X X     X   X   X X     X   X X X X X   X     X     X   X X X   X X
X XXXXXXXXXXX XXXXXXX XXXXXXX X X X XXXXXXX XXXXX X XXXXX XXXXX X X X XXXXX XXX XXXXXXX XXX X XXX X X
X   X       X X     X X       X X           X     X X   X   X   X X X X X   X   X       X   X X   X X
XXX X XXXXX X X XXX XXX XXXXXXX XXXXXXXXXXXXX XXX XXX X XXX X XXXXX X X X X X XXX X XXX X XXX X XXX X
X   X   X X X   X X   X X     X X   X     X   X   X   X X   X     X X X   X X X   X   X X   X X X   X
X XXXXX X X XXXXX XXX X XXX X X X X X XXX X XXXXXXX XXX X XXXXXXX X X XXXXX X XXXXX X XXXXX X X X XXX
X     X X X       X   X   X X X X X   X X X         X   X         X   X     X     X X     X X X X   X
XXX X X X X XXXXX X XXX X X XXX X XXXXX X X XXXXXXXXX XXX XXXXXXXXX XXX XXXXXXXXX XXXXX X X X X XXX X
X   X X X X     X X   X X X   X   X   X   X X       X   X X   X   X X   X   X   X     X X   X X   X X
X XXX X X XXXXX X XXX X X XXX XXXXX X X XXX X XXXXXXXXX XXX X X XXX XXX X XXX X XXXXX X XXXXX X X X X
X X   X X X   X X X   X X   X   X   X   X X X     X   X     X X     X   X X   X       X   X X X X X X
X XXXXX X X X X XXX XXX XXX XXX X XXXXXXX X X XXX X X XXXXXXX X XXXXX XXX X XXXXXXXXXXXXX X X XXX X X
X         X X   X   X     X X   X X     X X X   X   X     X   X       X   X   X     X       X   X X X
X XXXXXXXXX X XXX XXXXXXXXX X XXX X X X X X XXX XXXXXXXXX X XXXXXXXXXXX X XXX XXX X XXXXXXX XXX X X X
X   X   X   X X   X         X     X X X X     X X       X X   X   X     X     X   X     X X X   X   X
XXX X X X X XXX XXX XXXXXXXXX XXXXX X X XXXXX X X XXX XXX XXX XXX X XXXXXXXXXXX XXXXXXX X X X XXX XXX
X X X X   X X   X     X     X   X   X X   X X X   X   X     X   X X         X   X   X   X X X X X   X
X X X XXXXX X XXX XXX X XXX XXX XXXXX XXX X X XXX XXXXX XXXXX X X X XXXXXXX X XXXXX X XXX X X X XXX X
X X X     X X   X   X X X X X         X X X X X   X     X   X X X   X     X   X     X X     X X   X X
X X XXXXX XXXXX X XXX X X X XXXXXXXXXXX X X X XXXXX X XXX X XXX XXXXX XXX XXXXX X XXX XXXXX X X XXX X
X X X   X   X   X X   X   X   X   X     X X X X   X X X   X     X     X   X   X X   X     X X X     X
X X X X XXX X XXX X XXXXX XXX X X XXX X X X X X X X XXX XXXXXXX X XXXXX XXX X XXXXX XXXXX X X X XXXXX
X X X X X   X X   X       X   X X     X X X     X X   X X     X X   X   X   X     X     X X X X X   X
X X XXX X XXX XXXXXXXXXXXXX XXX XXXXX XXX XXXXXXX XXX X XXX X X XXX X X X XXXXXXX XXX X X X X XXX X X
X X X   X     X             X     X   X   X     X   X X   X X   X X X X X X     X   X X   X X     X X
X X X X XXXXXXX XXXXXXXXXXXXX XXX XXXXX XXX XXX XXX X XXX X XXXXX X X XXX XXX X XXX X XXXXXXXXXXXXX X
X   X X X       X     X     X X X     X     X X   X X X   X       X X         X X   X X             X
X XXX X X X XXXXXXX XXX X XXX X XXXXX XXXXXXX XXX X X X XXX XXXXXXX XXXXXXXXXXXXX XXX XXX X XXXXXXX X
X X   X X X   X   X   X X     X     X     X       X   X X   X       X     X       X X   X X   X     X
X X XXXXX XXX X X XXX X XXXXXXX XXX X XXX X XXXXXXXXXXX X XXX XXXXXXX XXX X XXXXXXX XXX X XXX XXXXX X
X X     X   X X X X   X X       X   X   X X   X       X X   X X   X   X   X   X         X   X     X X
X XXX X XXX X X X X X X X XXXXX XXXXXXX XXXXX X XXX X X XXX X X XXX XXX XXXXX X XXXXXXXXXXX XXXXX XXX
X   X X     X X X X X X X X   X       X       X X   X X X   X   X   X X X     X       X         X   X
XXX XXXXXXXXX X X X XXX X X XXXXX X XXXXXXXXXXXXX XXX X XXXXXXX X XXX X XXX XXXXXXXXX XXXXXXXXXXXXX X
X X           X X   X   X X X   X X     X   X     X   X         X X   X X   X       X         X   X X
X XXXXXXXXXXXXX XXXXX XXX X X X X XXX X X X XXX XXX XXX XXXXXXXXX X XXX X XXX XXXXX XXXXXXXXX X X X X
X         X       X   X     X X X   X X   X   X   X   X     X X   X X   X     X   X X       X   X X X
X X XXXXX XXXXXXX X XXXXXXX X X XXXXX XXXXXXX XXX XXX XXXXX X X XXX X XXXXXXXXX X X X XXXXX XXXXX X X
X X     X X     X X     X   X X       X     X     X X   X     X X   X X     X   X   X X X   X   X   X
X XXXXX X X XXX X XXXXX XXXXX XXXXXXXXX X X XXXXXXX XXX XXXXX X X X X X XXX X XXXXXXX X X XXX XXXXX X
X   X   X   X         X       X   X   X X X X         X     X X X X X X   X   X       X   X X   X   X
XXXXX XXXXXXXXXXXXXXX XXXXXXXXXXX X X X X XXX XXX XXX XXXXX XXX X X X XXX XXXXX XXXXXXX XXX X X X XXX
X     X     X       X             X X   X       X   X   X X     X X X     X   X     X   X   X X X   X
X XXX X XXX X XXXXX X XXXXXXXXXXXXX XXXXXXXXXXXXXXX XXX X XXXXXXX X XXXXXXX X X XXX XXX X X X X XXX X
X   X X   X X X     X X                     X       X     X   X   X         X X   X   X X X   X   X X
XXX X XXX X X X XXXXXXX XXXXXXXXXXXXXXXXXXX X XXXXXXXXXXX X XXX XXXXXXX XXXXX XXXXX X X XXX XXXXX X X
X   X   X X   X           X   X   X     X   X         X X X     X   X   X   X     X X X   X X     X X
X XXXXXXX XXXXXXXXXXXXXXXXX X X X X XXX X XXXXXXXXXXX X X X XXXXX X X XXXXX XXXXX XXX XXX XXX XXXXX X
X     X   X   X       X     X X X   X   X       X     X   X X   X X X   X     X       X       X   X X
X XXX X XXX X XXX X XXX XXXXX X XXXXX XXXXXXXXX X XXXXX XXX XXX X X XXX X XXXXX XXXXXXXXXXXXXXX X X X
X   X   X   X   X X X   X   X   X   X   X       X     X X       X X   X X X     X   X           X   X
XXX XXXXX XXXXX X X X XXX X XXXXX X XXX XXXXX XXXXXXX X XXX XXXXX XXX X X X XXXXX X X XXXXXXXXXXXXXXX
X X X       X     X X   X X   X   X   X     X X     X X   X X   X   X X X X     X X   X         X   X
X X XXXXXXX XXXXXXX XXX X X X X XXXXXXXXXXX X XXXXX X XXX XXX X XXX X X X XXXXX X XXXXXXX XXXXX X X X
X X X     X   X   X X   X X X   X         X X X     X   X   X X   X X   X   X   X X       X     X X X
X X X XXX XXX X X X X XXXXX XXXXX XXXXXXX X X X XXX XXX XXX X XXX X XXXXX XXX XXX XXXXX XXXXX XXXXX X
X X X X       X X   X X     X   X X     X   X   X     X   X   X   X X           X X   X     X X     X
X X X XXXXXXXXX XXXXX X XXXXX X X XXXXX XXXXX XXXXXXXXXXX XXXXX XXX X XXXXXXXXXXX X X XXXXX X X XXX X
X   X       X X X   X X       X           X   X         X X   X X   X       X   X   X   X   X X   X X
X XXXXXXXXX X X X XXX XXXXXXXXXXXXXXXXXXX XXXXX XXXXXXX X X X X X X X XXXXXXX X XXXXXXX X XXX X X X X
X X         X X X   X   X   X         X       X   X   X   X X   X X X X   X   X     X   X X   X X X X
X X XXXXXXXXX X XXX XXX X X X XXXXXXX XXXXXXX XXX XXX XXXXX XXXXX X XXX X X XXXXX XXX XXX X XXXXX X X
X X     X     X   X   X X X   X     X       X     X       X     X X X   X X     X     X   X     X X X
X X XXX X X XXXXX XXX X X XXXXX XXX XXXXXXX XXXXXXX XXXXX XXXXX XXX X XXX XXXXX XXXXXXX XXXXXXX X XXX
X X X   X X     X     X   X     X     X   X       X   X   X X       X X X   X   X       X     X X   X
X XXX XXX XXX X XXXXX XXXXXXXXX X XXXXX X XXXXXXX X X X XXX X XXXXXXX X XXX X XXXXX X XXXXXXX X XXX X
X     X X X   X   X           X X       X     X   X X X     X X X     X   X   X   X X X       X   X X
XXXXXXX X X XXX XXX XXXXXXXXX X XXXXXXXXX X XXX XXX X XXXXXXX X X XXXXXXX XXXXX X XXX X XXXXX XXX X X
X   X     X   X X   X     X X X X       X X X   X X X X         X X         X   X     X X X   X   X X
X XXX XXXXXXX X X XXX XXX X X X X XXXXX X XXX XXX X X X XXXXXXXXX XXX XXXXX X XXXXXXXXX X X XXX XXX X
X X   X     X X X   X X   X X X X X   X X   X X     X X   X   X   X   X   X X X         X     X   X X
X X XXXXXXX X XXX XXX X XXX X X X X X X XXX X XXXXXXX XXX X X X XXX XXX X X X X XXX XXXXXXXXXXXXX X X
X X         X     X   X X   X X   X X X   X X     X   X   X X X X   X   X X   X   X       X     X   X
X XXXXXXXXX XXXXXXX XXX XXX X XXXXX X XXX X XXXXX X XXX XXX XXX X XXXXXXX XXXXXXX XXXXXXX X XXX XXX X
X     X   X X X     X X   X X   X X X     X     X X X   X X   X   X     X       X X   X   X X X   X X
XXX X X X X X X XXXXX XXX X XXX X X XXXXXXXXX X X X X XXX X X XXXXX XXX XXX XXX X X X X XXX X XXX X X
X   X X X X   X X   X     X X   X   X         X X X   X X   X       X X   X   X X X X X   X X   X   X
X XXXXX X X XXX X X X XXXXX X XXXXXXX XXXXXXX XXX X XXX X XXXXX XXXXX XXX XXX X X X X XXX X XXX XXXXX
X X     X   X   X X X X X             X X   X X   X   X       X X       X X   X X X X X   X     X   X
X X XXXXXXXXX XXX X X X X XXXXXXXXXXXXX X X X X XXXXX XXXXXXX X XXXXXXX X X XXXXX X X X X XXXXX XXX X
X   X       X X   X X X     X   X         X   X   X X   X     X       X     X     X X   X X     X   X
X XXX XXXXX X XXXXX X X XXXXX X XXXXX XXXXXXXXXXX X XXX XXXXX XXXXXXX XXXXXXX XXXXX XXXXX X XXXXX XXX
X   X   X   X X     X X   X   X     X       X X   X   X     X   X     X   X   X     X     X   X     X
XXX XXXXX XXX X XXXXX X XXX XXXXXXX XXXXXXX X X XXXXX XXXXX XXXXX XXXXX X X XXX XXXXXXXXXXXXX X XXX X
X X X   X X   X   X   X X   X     X   X       X X       X   X   X     X X   X   X             X X   X
X X X X X X XXXXX X XXXXX XXXXX XXXXX XXXXXXX X X X XXXXX XXX X XXXXX X XXXXX XXX XXXXXXXXXXXXX X X X
X X   X X X     X X X     X   X     X     X   X X X     X     X     X   X   X   X X           X X X X
X XXXXX X XXXXX X X XXX X X X XXXXX XXXXX XXXXX X XXXXX X XXXXXXXXX XXX X X XXX X XXXXX XXX X XXX XXX
X   X   X   X   X       X X X X   X     X       X   X X   X     X     X X X     X     X   X X   X   X
X X X XXX X X XXXXXXXXXXXXX X X X XXX X XXXXXXXXXXX X XXXXX XXX XXXXX XXX XXXXX XXXXX XXX X XXX XXX X
X X X   X X X X   X         X   X   X X           X X   X   X X     X   X X       X X X   X X   X   X
X X XXX X XXX X X X XXXXXXXXXXXXXXX XXXXX XXXXXXX X XXX X XXX XXXXX XXX X XXXXXXX X X XXXXX X XXX X X
X X X   X   X   X   X       X     X     X   X     X X   X X       X X   X       X   X       X X   X X
X XXX XXXXX XXXXXXXXX XXXXXXX X XXXXXXX X X XXXXXXX X XXX XXXXX XXX X XXXXXXXXX XXX XXXXXXXXX XXX XXX
X     X         X     X       X X   X   X X   X     X   X       X   X           X X X X     X   X   X
X XXXXX XXXXXXX XXX XXX XXXXXXX X X X XXX XXX X XXXXXXX XXXXXXX X XXXXXXXXXXXXXXX X X X X X XXX XXX X
X X     X   X       X   X     X   X X   X X   X X       X     X X   X   X           X   X X   X     X
X XXX X X X XXXXXXXXX XXX X XXXXXXX XXX X X XXX X X XXXXX XXX X XXX X X X XXXXXXX XXXXXXX XXX XXXXX X
X   X X   X X       X X   X   X   X   X X X     X X X     X X   X   X X   X X   X X       X   X     X
XXX XXXXXXX X XXXXX X X XXXXX X X XXX X XXX XXXXX XXX XXXXX XXXXX XXX XXXXX X X X X X XXXXXXXXX XXXXX
X X       X     X X X X     X X X     X   X X     X   X         X X X X     X X X   X X   X   X     X
X XXXXXXX XXXXX X X X XXXXXXX X XXXXXXXXX X X XXXXX XXX X XXX XXX X X X XXXXX X XXXXXXX X X X XXXXX X
X       X     X   X   X       X   X   X   X   X     X   X   X X   X   X X     X       X X   X   X   X
X X X XXXXXXX XXX XXXXX XXXXX XXX X X X XXXXX X XXXXXXXXXXX X X XXXXX X X XXXXXXXXXXX X XXXXXXX X XXX
X X X X       X       X X     X X X X X X     X       X     X X     X   X X     X   X   X   X   X X X
XXX X X XXXXXXXXXXXXX X X XXXXX X X X X X XXXXXXXXXXX X XXXXX XXXXX X XXX X XXX X X XXXXX X X X X X X
X   X X     X     X   X X   X   X X X X X           X X X   X X     X X   X X     X   X   X X X X X X
X XXX XXXXX XXX X XXX X XXX XXX X X X X XXXXXXXXXXX X X X X XXX XXXXXXX XXX XXXXX XXXXX XXX X X X X X
X X   X     X   X   X X   X     X X X X   X       X X X   X   X         X   X   X X   X   X   X X   X
X X XXX XXXXX XXXXX X XXX XXXXXXX X X XXX X XXX XXX X XXXXXXX XXXXXXXXXXX XXX X XXX X XXX XXXXX XXX X
X X   X     X X   X X X   X   X   X X X   X   X X   X     X       X       X   X     X   X X X   X   X
X XXXXXXXXX X X XXX X X XXX X X XXX X X X XXXXX X XXXXXXX X XXXXX XXX XXX X XXXXXXXXX XXX X X XXX XXX
X X         X X     X   X   X X     X X X X   X         X   X   X   X X X   X       X   X X   X   X X
X X XXXXXXXXX X XXXXXXX X XXX XXXXXXX X XXX X XXXXXXXXXXXXXXX XXXXX X X XXXXX XXXXX XXX X XXX X XXX X
X X   X       X X     X X   X   X   X X     X               X X     X   X X   X       X X   X X     X
X XXX X XXXXXXX X XXX X XXX XXX X X X XXXXXXXXXXXXXXXXX XXX X X XXXXXXX X X XXXXXXXXX X XXX X XXXXX X
X   X   X X     X X   X X X   X   X X     X       X   X X     X X     X   X       X X     X X     X X
X XXXXXXX X XXXXXXX XXX X XXX XXXXX X X XXX X XXX X X X XXXXXXX X XXX X XXXXXXXXX X XXXXX X XXXXXXX X
X       X X     X   X     X   X   X X X   X X X   X X X         X   X X X         X       X     X   X
X XXX X X XXXXX X X X XXXXX XXXXX X XXXXX X X X XXX XXXXXXXXXXXXXXX X XXX XXXXXXXXX XXXXXXXXXXX X XXX
X X   X     X   X X X X   X X     X     X X X X X X       X         X X   X X     X   X   X   X X   X
X X XXXXXXXXX XXX XXX X X X X XXX XXXXX X X X X X X XXX X XXX XXXXXXX X XXX X X XXXXX X XXX X X XXX X
X X     X     X       X X   X X X X   X X   X X X     X X     X     X   X   X X     X X X   X X X   X
X XXXXX X XXXXXXXXXXX X XXXXX X X X X X XXXXX X XXXXXXX XXXXXXX XXXXXXXXX XXX XXX XXX X X XXX X X XXX
X X   X   X         X X X     X     X X       X X     X   X     X           X X X     X X X X X   X X
X X X XXXXXXX XXXXX X X XXXXX XXXXXXXXXXXXXXXXX X XXX XXX X XXX X XXXXXXXXX X X XXXXXXX X X X XXXXX X
X X X         X   X X X   X   X     X         X   X   X   X   X X   X     X X   X           X   X   X
X XXXXXXXXX XXX X X XXXXX X XXX XXX X XXXXX XXXXXXX XXX XXXXX X XXX XXX X X XXX XXXXXXXXXXXXX X X X X
X           X   X         X       X       X             X     X         X X                   X   X K
XXXXXXXXXXXXXXXXXXXXXXXXXXXXXXXXXXXXXXXXXXXXXXXXXXXXXXXXXXXXXXXXXXXXXXXXXXXXXXXXXXXXXXXXXXXXXXXXXXXXX
