XXXXXXXXXXX
P X       X
X X XXXXX X
X     X   X
XXXXXXX XXX
X       X X
XXXXX XXX X
X       X X
X X XXXXX X
X X       K
XXXXXXXXXXX
