XXXXXXXXXXXXXXXXXXXXXXXXXXXXXXXXXXXXXXXXXXXXXXXXXXXXXXXXXXXXXXXXXXXXXXXXXXXXXXXXXXXXXXXXXXXXXXXXXXXXX
P   X                           X               X             X     X           X             X     X
X XXX XXXXXXXXXXX XXXXXXXXX XXX X XXXXXXXXXXXXXXX X X XXXXXXX X XXXXX XXX XXXXX XXX XXXXX XXXXX XXX X
X     X         X   X   X   X   X     X   X   X   X X X   X   X     X X   X   X   X X   X X     X X X
X XXXXX XXXXXXX XXXXX X X XXX XXXXX X X X X X X XXX XXX X X XXXXXXX X X XXXXX XXX XXX X X X XXXXX X X
X   X   X     X X     X X X X     X X   X X X   X X     X X   X     X X X   X     X   X X         X X
XXXXX XXXXXXX X X XXXXX X X XXXXX XXXXXXX X XXXXX XXXXX X XXX X XXXXX X X X X XXXXX XXX XXXXXXXXX X X
X     X   X   X X X   X   X     X X       X   X   X   X X   X   X     X   X X X     X X   X X     X X
X XXXXX X X X X X XXX XXXXX XXXXX X XXX XXXXX X X X X XXX X XXXXX XXXXXXXXX X XXX XXX XXX X X XXXXX X
X     X X   X X   X   X X         X   X X   X X X X X   X X X       X   X   X X   X X   X X X X     X
XXXXX X XXXXXXXXXXX X X X XXXXXXXXX X X X X X X X X XXX XXX X XXXXXXX X X XXX X XXX X X X X X X XXX X
X X   X X           X X X X         X X X X X   X X X X   X   X   X   X X X X   X     X X X   X X   X
X X XXX X XXX XXXXXXX X X XXXXXXXXXXX XXX X XXXXX X X XXX XXXXX X X XXX X X XXXXX XXXXX X X XXX XXXXX
X X X     X   X     X   X     X     X     X       X X   X       X   X   X X X         X X X   X     X
X XXXXXXXXX XXX X XXXXX XXXXX X XXX XXXXXXXXX XXXXX XXX XXXXXXXXXXXXX XXX X X XXXXXXXXX X XXXXXXXXX X
X           X   X   X   X X   X X     X     X   X   X       X   X     X   X     X       X     X     X
X XXX XXXXXXX XXXXX X XXX X XXX XXXXX X XXX XXXXX XXX XXXXX XXX X XXXXXXX X XXXXX XXXXXXXXXXX X XXX X
X   X       X   X X   X   X   X     X   X X     X X   X     X   X X       X X     X         X X   X X
XXX XXXXXXX XXX X XXXXX XXXXX XXXXX XXXXX XXXXX X XXX X XXXXX XXX XXXXX XXX X XXX X XXXXX XXX XXX XXX
X   X     X X X X       X   X     X     X     X X   X X X     X   X     X   X   X X     X   X   X   X
X XXX XXX X X X X XXX XXX X XXXXX XXXXX X XXX X XXX X X X XXX X XXX XXXXXXXXX X X XXX XXXXX XXX XXX X
X X   X   X X   X   X X   X       X     X   X X   X X X   X   X   X X   X   X X X X   X     X X X   X
X XXX X XXX X XXX XXX X XXXXXXXXXXX XXXXXXX XXXXX X X XXXXXXXXXXX X X X X X XXX XXX XXX XXX X X X X X
X X   X X   X   X X   X     X       X     X     X   X           X   X X X X   X X     X   X   X   X X
X X X XXX XXXXX XXX X XXXXX X XXX XXX XXX XXXXX XXXXX XXXXXXX X XXXXX X X XXX X X XXXXXXX XXX XXXXX X
X   X X   X   X   X X     X X   X     X   X   X           X   X       X X X   X   X   X   X X X   X X
XXXXXXX XXX X XXX X XXXXX X XXXXXXXXXXX XXX X XXXXXXXXXXXXX XXXXXXXXXXX X X XXXXXXX X X XXX X X X X X
X       X X X X   X   X   X   X       X X   X               X         X X X       X X X   X X X X   X
X XXXXXXX X X X XXXXX X XXXXX X XXXXX X X X XXXXXXXXXXXXXXXXX XXXXXXX X X XXXXXXX X X XXX X X X XXXXX
X     X     X X   X   X     X X X   X   X X X               X   X   X   X X X   X   X     X X X     X
X XXX X XXXXX XXX X XXXXXXXXX X XXX XXXXX X XXXXXXXXX XXXXXXXXX X XXXXX X X X X XXXXXXXXXXX X XXXXX X
X X   X   X X     X       X   X X   X   X X       X   X   X   X   X   X   X   X               X   X X
X X XXXXX X XXXXXXX XXXXX X XXX X X X X XXX XXXXX X XXX X X X X XXX X XXXXXXX XXXXXXXXXXX XXXXXXX X X
X X     X X       X X   X X     X X   X   X X     X   X X   X X X   X       X   X       X X       X X
X XXXXX X X XXXXX X X X X XXXXXXX XXXXXXX XXX XXXXXXX X XXXXX X X XXXXXXXXX XXXXX XXXXX X XXXXX X X X
X X   X X   X   X X   X X X   X     X   X     X       X X   X   X X       X       X   X X       X X X
X X XXX XXXXX X X XXXXX X X X X XXX X X XXXXXXXXX XXX X X X XXXXX X XXXXX XXXXXXXXX XXX XXXXX XXXXX X
X X   X   X   X X   X   X X X   X   X X     X     X   X X X     X   X   X   X     X   X X   X X     X
X XXX XXX X XXXXXXX X XXX X XXXXX XXXXXXX X X X XXX XXX X X X XXXXXXX XXXXX XXX X XXX X X X X X XXXXX
X       X X         X   X X X   X X   X   X X X   X   X X X X X       X     X   X   X X X X X X   X X
XXXXX XXX XXXXXXX XXX XXX X X XXX X X X XXX XXXXX XXXXX X X XXX XXX XXX XXXXX XXXXX X X X X XXXXX X X
X X   X   X     X   X X   X X X   X X X   X   X   X   X X X   X X X     X     X       X X X     X   X
X X XXX X X XXX XXX XXX XXX X X X X X XXX XXX X XXX X X XXXXX X X XXXXXXX XXXXX XXXXXXX X XXXXX XXX X
X   X X X X X X   X   X X   X X X X X   X X     X   X       X X X         X   X X X   X   X   X     X
X XXX X XXX X XXX XXX X X XXX X XXX XXX X XXXXXXX XXXXXXXXX X X XXX XXX XXX X X X X X XXXXX X XXXXXXX
X   X X   X   X X   X   X X   X     X   X   X     X       X   X   X   X X   X     X X     X X     X X
XXX X XXX XXX X XXX XXXXX X XXXXXXXXX XXX X X XXXXX XXXXX XXX XXX XXXXX X XXXXXXXXX XXX X X XXXXX X X
X   X   X   X   X X       X         X   X X X X X   X   X X   X   X   X X   X     X   X X   X   X   X
X XXX XXX XXXXX X XXXXXXXXXXXXX XXXXX X X X X X X XXX X X XXXXX XXX X X XXXXX XXX XXX X XXXXX X XXXXX
X X   X   X   X X     X       X X   X X X X     X X   X X X     X   X X X   X X X   X X     X X     X
X X X X XXX X X X XXX XXX XXX X X X X X X XXXXXXX X X X X X XXXXX XXX X X X X X X XXX XXXXX X XXXXX X
X   X X     X X   X X   X X   X X X X X X X   X   X X X X X X     X X X   X X   X     X   X X X   X X
XXXXX XXXXXXX XXXXX XXX X X XXX X X XXX XXX X X XXXXX XXX X X XXXXX X XXXXX XXX XXXXXXX X X X X X X X
X   X   X   X         X   X X   X X   X X   X     X   X   X X   X   X X       X X   X   X X     X X X
X XXXXX XXX XXXXXXXXX XXXXX XXX X XXX X X XXXXXXX X XXX X X XXX XXX X X XXXXX X X X XXX XXXXX XXXXX X
X     X X     X X     X   X   X X   X   X X     X   X   X X     X   X X X   X X   X     X   X X     X
X X XXX X XXX X X XXX X X XXX X XXX XXXXX X XXX XXXXX XXX XXXXXXX X X X XXX X XXX XXXXXXX X XXX XXX X
X X X   X   X   X   X   X   X   X X     X X   X       X           X X X   X   X   X   X   X     X   X
X X X XXXXX XXX XXX XXXXXXX XXX X XXXXX X XXX XXXXXXXXXXXXXXXXXXXXX X X X X XXX XXX X X XXXXXXXXX XXX
X X X X     X   X   X     X X X X   X   X   X                     X X X X X   X X   X   X   X     X X
X X X X X XXXXXXX XXX XXX X X X X XXX XXXXX XXXXXXXXXXXXXXXXXXXXX X X X X XXXXX X XXXXXXX X X XXXXX X
X X   X X   X   X X X X X X   X   X   X     X         X       X   X X X X       X       X X X X     X
X XXXXXXXXX X X X X X X X X XXXXX X XXX XXXXXXXXXXX X XXX X X X XXXXX XXXXXXX XXXXXXX X X X X XXXXX X
X X         X X   X X X X   X     X X   X     X   X X   X X X X     X X     X X     X X   X X     X X
X X XXXXXXX X XXXXX X X XXXXX XXXXX X XXX XXX X X X XXX XXX X XXXXX X X XXX XXX XXX XXXXXXX XXXXX X X
X X   X   X X X         X     X   X   X     X   X   X   X   X X   X X   X X     X X     X   X X   X X
X X X X X X X XXXXXXXXXXX XXXXX X XXXXXXXXX XXXXXXXXX XXX XXX X XXX XXXXX XXXXXXX XXXXX X XXX X XXX X
X X X X X X X   X     X   X   X X       X   X     X X X     X   X         X           X X   X       X
X XXX X X X XXX X XXX X XXX XXX XXXXX X X XXXXX X X X XXXXX XXXXX XXXXXXXXX XXXXXXXXX X X X XXXXXXX X
X     X X X X X X X X X X       X   X X   X     X X X     X     X X         X       X   X X     X   X
XXXXXXX X X X X X X X X X XXXXXXX XXX XXXXXXX XXX X XXXXX XXXXX X X XXXXXXXXXXXXX XXXXXXX XXXXX XXX X
X       X X   X X X X X X X       X   X     X X   X   X X X     X   X           X X     X     X   X X
X X XXXXX XXX X X X X X X XXXXXXX X XXXXX X X XXX X X X X X XXX XXXXXXXXXXX X X X X XXX XXXXX XXX X X
X X     X X   X   X X   X     X   X X     X X   X X X   X   X X   X       X X X X X   X         X X X
X XXXXX XXX XXXXXXX XXXXXXXXX X XXX X XXXXX X X X X XXX XXXXX XXX X XXXXX XXX X X X XXXXXXXXXXXXX X X
X X X   X   X   X       X   X X X   X   X X X X X X X   X     X   X   X X     X X   X           X X X
X X X X X XXX X X XXXXX X X X X X XXX X X X XXX X X X XXXXX XXX XXX X X XXXXXXX X XXX XXXXXXXXX X XXX
X X X X X   X X X   X   X X     X   X X X       X   X     X   X X   X X       X X X   X     X   X   X
X X X XXXXX X X XXX XXXXX XXXXXXXXX X X X XXXXXXXXXXXXXXX XXX X X XXX XXXXX XXX X X XXX XXX X XXXXX X
X   X   X   X X   X       X       X X X X   X           X X   X X   X X     X   X X X   X X X       X
XXX XXX X XXX XXX X XXXXXXX XXXXX X XXX X XXX XXXXXXXXX X X XXX XXX X X XXX X XXX X X XXX X XXXXXXXXX
X   X X X X   X X X   X   X X   X   X   X X   X       X X   X   X   X X   X X X   X       X         X
X XXX X X XXX X X XXX X X X X XXXXXXX XXX X XXX XXX XXX XXXXX XXXXX X X X XXX XXXXX XXXXXXXXXXXXXXX X
X     X   X   X X   X   X X X       X   X X     X X X   X     X   X X X X   X X   X X   X   X       X
XXXXX XXXXX XXX XXX XXXXXXX X XXXXX X X XXXXXXXXX X X XXX XXXXX X X X XXXXX X X X XXX X X X X XXXXX X
X   X X     X     X       X X     X   X       X     X   X       X X X     X   X X     X   X X     X X
X XXX X XXXXX XXXXXXXXXXX X XXXXX XXXXXXXXXXX X XXXXXXX XXXXXXXXX XXXXXXX X XXX XXXXXXXXXXX XXXXX XXX
X X   X X   X           X X     X   X       X X X     X       X X X       X   X X         X     X   X
X X XXX X X X XXXXX XXX X XXXXX XXX XXXXXXX X X XXX X XXX XXX X X X XXXXXXXXX X X XXXXXXX XXXXX XXX X
X X X     X X     X   X X X     X   X   X   X X     X X X   X X X   X   X     X       X   X   X   X X
X X XXXXX X XXXXX XXX XXX X XXXXX XXX X X X X XXXXXXX X XXX X X XXXXXXX X XXXXX XXXXX X XXXXX XXX X X
X X X   X X   X X X X     X   X X     X   X X     X   X   X X X         X   X   X   X X   X     X   X
X X X X XXX X X X X XXXXXXX X X XXXXXXXXXXX XXXXX X XXX X X X XXXXX XXX XXX XXXXX X X XXX X XXX XXX X
X   X X   X X X X   X       X X       X   X X     X X   X X X     X X     X X     X X   X X   X X X X
X XXX XXX XXX X XXX X XXXXXXX X XXXXX X X X X XXXXX X XXX X XXXXX X XXXXXXX X XXXXX XXXXX X X X X X X
X X   X   X   X     X X   X   X X     X X   X X     X X   X X   X X X       X X X   X     X X X   X X
X X XXX XXX XXX XXXXXXX X X XXX XXXXXXX XXXXX X XXXXX X XXX X X X X X XXXXXXX X X XXX XXXXX X XXX X X
X X   X     X   X     X X   X     X   X   X   X     X X X   X X X X X X       X       X     X X   X X
X X X XXXXXXX XXXXX X X XXXXXXXXX X X XXX X XXXXXXX X X X XXXXX X X X X X XXXXXXXXXXXXX XXXXX XXXXX X
X X X X       X     X   X         X X   X X   X     X X X   X   X X X X X       X   X   X     X   X X
X XXX X XXXXXXX XXXXXXXXX XXXXXXXXX XXX X XXX X XXXXXXX XXX X XXX X X XXX XXXXX X X XXXXX XXXXX X X X
X   X X   X   X       X   X   X     X X   X X X X         X X   X   X   X X   X X X       X     X   X
XXX X XXX X X X XXXXX X XXX X X XXXXX XXXXX X X XXXXX XXXXX XXX XXX XXX X X XXX X X XXXXXXX XXXXXXXXX
X X X   X   X X X     X X   X   X X         X X   X   X   X X   X   X X X   X   X X X       X       X
X X X X XXXXX X X XXXXX X XXXXXXX X X XXXXXXX XXX X X X X X X XXX XXX X XXXXX XXX X X XXXXXXXXX X X X
X   X X   X   X X X     X X     X   X X         X   X X X   X   X X   X   X   X   X X         X X X X
X XXXXXXX X XXX X X X X X XXX X XXXXX X XXXXX XXXXXXX X X XXXXX X X X XXX X XXX XXX XXXXXXXXX XXX X X
X X       X X   X X X X X     X     X X     X X     X X X X   X X   X X X   X   X X     X     X   X X
X X XXXXXXX XXX X XXX X XXXXXXXXXXX X XXXXX X X X XXX X XXX X X XXXXX X XXXXX XXX XXXXX X XXXXX XXX X
X X X     X   X X X   X         X X X   X X X X X     X     X X   X           X   X     X X   X   X X
X X XXXXX XXX X X X XXXXXXXXXXX X X X X X X X X XXXXXXXXXXXXX X XXX XXXXXXXXXXX X X XXXXX X XXX X X X
X X     X     X X X       X   X   X   X   X X X   X       X   X   X   X       X X X X   X X     X X X
X XXXXX XXX XXXXX X XXXXX X X XXXXX XXXXXXX XXXXX X XXXXX X XXXXX XXX X XXXXX XXX X X X X XXXXX X XXX
X     X   X X     X   X X   X X     X       X     X X     X     X   X X X   X   X   X X X     X X   X
XXXXX XXX X X XXXXXXX X XXXXX X XXXXX XXXXX X XXXXXXX XXX XXXXX X XXX X X X XXX XXXXX X XXXXX XXXXX X
X   X X   X X   X X   X   X   X   X X   X   X   X     X   X     X     X X X X   X     X     X X     X
X X X X XXX X X X X XXX X X X XXX X XXX XXXXXXX X XXXXX XXX XXXXX XXXXX X X X X X XXXXX XXXXX X XXXXX
X X   X X X X X X X X   X X X   X X   X       X   X   X X   X   X   X   X X X X X X   X X     X     X
X XXXXX X X XXX X X XXXXX X XXXXX XXX XXXXXXX XXXXX X X X XXX X XXXXX XXX X X XXX X X X X XXXXXXXXX X
X       X       X         X                 X       X   X     X           X X       X X             K
XXXXXXXXXXXXXXXXXXXXXXXXXXXXXXXXXXXXXXXXXXXXXXXXXXXXXXXXXXXXXXXXXXXXXXXXXXXXXXXXXXXXXXXXXXXXXXXXXXXXX
