XXXXXXXXXXXXXXXXXXXXXXXXXXXXXXXXXXXXXXXXXXXXXXXXXXXXXXXXXXXXXXXXXXXXXXXXXXXXXXXXXXXXXXXXXXXXXXXXXXXXX
P       X   X         X     X         X     X     X         X       X             X         X       X
X XXX XXX X X XXXXXXX X XXX X X XXXXX XXX X X X X XXXXX XXX X XXX X X XXX XXXXXXX XXXXXXX X X XXX X X
X X   X   X X X     X   X   X X   X X   X X   X X   X   X X X   X X X   X X     X   X     X X X   X X
X XXXXX XXX X X X X XXXXX XXX XXX X XXX XXX XXX XXX X XXX X X XXX X XXX X X XXXXXXX X XXXXXXX X XXX X
X   X   X X   X X X X   X     X X X   X   X   X X     X   X X X   X X X X X       X X     X   X X   X
X X X XXX XXXXX X X X X XXXXXXX X XXX XXX XXXXX XXXXXXX X X X X XXX X X X XXXXXXX X X XXX X XXX X XXX
X X X X     X   X X X X X   X   X   X         X X   X   X   X X X X X   X       X X X   X     X X   X
X X X XXX X X XXX X X X X X X X XXX XXXXXXXXX X X X X XXXXXXXXX X X X XXXXXXXXX X X XXXXX XXXXX XXX X
X X   X   X X X   X   X   X   X   X     X   X X   X X   X   X   X   X       X   X   X   X X     X   X
X XXXXX XXX XXX XXXXXXXXXXXXXXXXX XXXXX X XXX X XXX XXX X X X XXX XXXXXXXXX X XXX XXX X XXX XXXXX XXX
X X     X   X   X       X         X     X     X X   X X X X   X   X       X X X X     X   X     X   X
X X XXXXX XXX XXX XXXXX XXXXXXXXXXX XXXXX XXXXXXX XXX X X XXXXX XXX X XXX XXX X XXXXXXXXX X XXX XXX X
X X   X       X   X   X   X   X   X   X X         X X   X X   X X X X X       X X       X X   X   X X
X X X X XXXXXXX XXXXX XXX X X X X X X X XXXXXXXXXXX X XXX X XXX X X X XXXXXXXXX X XXXXX X XXX XXX XXX
X X X X X     X     X   X X X   X X X X             X X   X   X X X X       X       X   X   X   X   X
X XXX X X XXX XXXXX X XXX X XXXXX X X X XXXXXXX XXX X X XXX X X X X XXXXXXX XXXXXXX X X XXX XXXXXXX X
X X   X X   X       X   X X X     X X X       X X   X X X   X X X   X     X X     X X X   X X       X
X X XXX XXX XXXXXXXXXXX X X X XXXXXXX XXX XXXXX X XXX X XXXXX X X XXX XXXXX X XXX XXX XXXXX X XXXXX X
X X X   X   X   X       X   X       X   X X     X   X   X   X X X X     X   X X X   X X   X   X   X X
X X X XXX XXX X X XXXXX XXXXXXXXXXX XXX X X XXXXX XXXXXXX X X X X XXXXX X XXX X XXX X X X XXXXX X X X
X X X X X     X X     X           X     X X X     X       X   X X       X   X   X X X   X       X X X
X X X X XXXXXXX X XXX XXXXXXXXXXXXXXX XXXXX XXXXXXX XXXXX XXX X XXXXXXX XXX XXX X X XXXXXXX XXXXX X X
X   X   X   X   X   X       X         X   X X       X   X   X X X     X X     X   X     X   X   X X X
XXXXXXX X XXX XXXXX XXXXXXX X XXXXXXXXX X X X XXXXXXX X XXX X X X XXX XXX XXXXX XXXXX X X XXX X X X X
X X   X X X   X         X X   X X       X X X       X X X   X X X   X   X   X   X   X X X X X X   X X
X X X X X X XXX XXXXXXX X XXXXX X XXXXXXX X XXXXXXX X X X XXXXX X X XXX XXX X XXX X XXX X X X XXXXX X
X X X   X X X   X     X     X   X X     X X           X X       X X X X   X   X   X     X X       X X
X X XXXXX X XXXXX XXX XXXXX X XXX XXXXX X XXXXXXX XXXXXXX XXXXXXXXX X XXX XXXXX XXXXXXXXX XXXXXXXXX X
X X       X X     X X X   X   X   X   X X       X X     X           X           X X   X   X   X     X
X X XXXXXXX X XXXXX X X X XXX X XXX X X XXXXXXX X X XXX XXXXXXXXXXXXXXXXXXXXXXXXX X X X X X X X XXXXX
X   X   X   X   X   X X X     X X   X X   X     X X X X                 X       X   X   X   X   X   X
X XXX X X XXXXX X X X X XXXXXXX X X X X X X XXXXX X X XXXXXXXXXXXXXXXXX XXXXX X X XXXXXXXXXXXXXXX X X
X X   X   X     X X X X X     X X X X X X X X   X X X     X     X     X     X X       X     X     X X
XXX XXXXX X XXXXXXX X X XXX X X XXX X X X X X X XXX XXX X X X XXX XXX XXXXX XXXXXXXXX X XXX XXX XXX X
X   X     X         X X     X X     X   X X   X   X X   X   X X     X     X X     X X   X X X   X   X
X X XXXXXXXXXXXXXXX X XXXXXXX XXXXXXXXXXX XXXXXXX X X XXXXXXXXX XXXXX X XXX X XXX X XXXXX X X XXX XXX
X X X               X X       X           X     X X X     X   X X     X X   X   X X       X X X     X
X X X XXXXXXXXXXXXXXX XXXXXXXXX XXXXXXXXXXX XXX X X X XXX X X X X XXXXXXX X XXX X XXXXX XXX X XXXXX X
X X X     X         X X         X     X     X X X X X   X   X   X X       X X   X     X   X X   X   X
X X XXXXX XXXXXXXXX X X XXXXXXXXX XXX X XXXXX X X X XXX XXXXXXXXX X XXXXXXXXX XXXXXXX X X X XXX X XXX
X X     X X         X X   X       X   X X   X X   X   X     X X   X X         X       X X X     X   X
X X XXXXX X XXXXXXXXX XXX XXX XXX XXXXX X X X X XXXXX XXXXX X X X X X XXXXXXXXX XXXXXXX X XXXXXXXXX X
X X X     X X         X X X   X   X   X   X X   X   X     X X X X X   X   X     X       X     X     X
X X X XXXXX X XXXXXXX X X X XXXXXXX X XXXXX XXXXX X XXXXX X X X X XXXXX X X XXXXXXX XXXXXXX X X XXXXX
X X X X     X       X   X X     X   X     X   X   X     X X   X X X     X X X     X X     X X X     X
X XXX X XXX XXXXXXX XXXXX X XXX X XXXXXXX XXX X XXXXXXX X XXX X XXX XXXXX X X XXX X XXX X X X XXXXX X
X   X X   X   X     X   X X X X   X     X   X   X       X   X X     X   X X   X   X     X X X     X X
X X X XXX XXXXX XXXXX X X X X XXXXX XXX X XXXXXXX XXX XXXXX X XXXXXXX X X XXXXX XXXXXXXXXXX XXXXXXX X
X X       X     X     X   X X     X X   X       X   X X     X     X   X       X       X     X     X X
X XXXXXXXXX X XXX XXXXXXXXX X X XXX X XXX XXX XXXXX XXX XXXXXXXXX X XXX XXXXXXXXXXXXX X XXXXX XXX X X
X     X     X X   X       X X X X   X X     X X     X   X   X     X X   X         X   X     X X X   X
X XXXXX XXX XXX XXX XXXXX X XXX X XXX X XXXXX X XXX X XXX X X XXXXX XXXXX XXXXXXX X XXX XXX X X XXXXX
X X     X   X   X X     X       X   X X   X   X X   X X X X X     X   X   X   X   X   X   X X   X   X
XXX XXXXX XXX XXX X XXXXXXXXXXXXXXX X X XXX XXX X XXX X X X XXXXX XXX X XXX X X X XXX XXX X XXX X XXX
X   X       X   X X X               X X X   X   X   X X   X     X X X   X   X X X X X   X X X   X   X
X XXXXXXXXXXXXX X X X XXXXXXXXXXXXXXX X X XXX XXXXX X XXXXXXX X X X XXXXX XXX X X X XXX XXX X XXXXX X
X   X     X     X X X     X         X X X   X     X X       X X X X   X   X X   X     X   X   X     X
XXX X XXX X XXXXX X XXXXX XXXXX XXX X X XXX XXXXX X XXXXXXX X XXX X XXX XXX XXXXXXXXX XXX X XXX XXX X
X   X   X   X   X   X   X   X   X   X X   X     X X X X   X X       X   X             X   X   X   X X
X XXXXX XXXXX X X XXX X XXX X XXXXX X XXXXX X XXX X X X X X XXXXX XXX XXXXXXXXX XXXXXXX XXXXX XXX XXX
X       X X   X X X   X     X     X X     X X X   X X   X X     X X   X       X   X   X   X X   X   X
X XXXXXXX X X X XXX X XXXXXXXXX X XXXXXXX X XXX XXX X XXX XXXXX XXX X X XXXXX XXX XXX XXX X XXX XXX X
X   X X     X X     X X   X   X X       X   X   X X X X     X   X   X X     X X   X   X   X   X     X
XXX X X XXXXX XXXXX XXX X X X XXXXX XXX X XXX XXX X X X XXX X XXX X XXXXXXX X X XXX XXX XXX X XXXXX X
X X X   X   X X X   X   X   X     X   X   X   X X   X X X   X X   X X     X X X   X X   X   X   X   X
X X X XXXXX X X X XXX XXXXXXXXXXX XXXXXXXXX XXX X XXXXX XXXXX X X XXX X X X X XXX X X XXXXX XXX X XXX
X X X     X X X     X   X     X         X   X   X       X     X X X   X X X X X     X     X   X   X X
X X XXXXX X X X XXXXXXX XXXXX X XXXXXXX X XXX X X XXXXXXX XXXXX X X XXX XXX X X XXXXXXXXX XXXXX XXX X
X X     X X X X X     X     X   X     X   X   X   X   X   X     X X X X     X X X X       X   X     X
X XXXXX X X X X X XXX XXXXX X XXX XXX X XXXXXXXXXXX X X XXX XXXXX X X XXXXXXX X X X XXXXXXX X XXXXX X
X   X   X   X X X X     X   X   X   X X X     X     X X   X X     X         X X   X         X X   X X
X X X XXXXX X X X X XXX X XXXXXXXXX X X X XXX X XXXXX XXX X XXX XXXXXXXXXXX X XXX XXXXXXXXXXX X X XXX
X X X X     X X X X X   X         X X X X X X X X   X X   X   X   X     X   X X     X     X X   X   X
XXX X X XXXXX XXX X XXXXXXXXXXXXX X X XXX X X X XXX X X XXX X XXX X XXX X XXX XXXXX X XXX X XXXXXXX X
X   X X X   X     X         X   X   X       X X     X   X   X X   X X   X   X     X   X X X       X X
X X X XXX X XXXXXXXXXXXXX X XXX XXXXXXXXXXXXX XXXXX XXXXX XXX X XXX X XXXXX XXXXX XXXXX X XXX XXX X X
X X X   X X         X   X X       X       X     X   X     X X X X   X X     X X   X   X X   X X   X X
X X XXX X XXXXXXXXX X X X XXXXXXX XXX X XXX XXXXX XXX XXXXX X XXX XXX X XXXXX X XXX X X XXX XXX XXX X
X X X   X X       X   X X   X   X   X X X   X     X X   X   X   X X   X X     X X   X     X X   X   X
X X X XXX XXXXXXX XXXXX XXX X XXXXX X X X XXX XXXXX XXX X X XXX X X XXX X XXX X XXX XXXXXXX X X X XXX
X X X X       X       X X   X X     X X X     X   X     X X   X   X X   X X   X X   X   X     X X   X
X XXX X XXXXX X XXXXXXX X XXX X XXXXX X XXXXXXXXX X XXXXXXX X XXXXX X XXXXX X X X XXX X X XXXXXXXXX X
X     X X   X X         X X   X   X   X     X     X     X   X     X     X   X X X   X X   X   X   X X
X XXXXXXX X X X XXXXXXXXX X XXXXX X XXXXXXX X XXX XXXXX X XXXXXXXXXXXXX X XXXXX XXX X XXXXX X X X X X
X X       X   X   X       X     X   X   X   X X     X     X           X X X     X   X X   X X   X   X
X XXX XXXXXXXXXXX X XXXXX X X XXXXXXX XXX XXX XXXXXXX XXXXX XXXXXXXXX X X X XXXXX XXX X XXX XXX XXXXX
X   X X X       X X X     X X       X   X X X         X     X     X   X   X   X   X     X   X   X   X
XXX X X X X XXXXX XXX XXXXX XXXXX XXX X X X X XXXXXXXXX XXXXX X XXX XXXXXXXXX X XXX XXXXX XXXXXXXXX X
X X X X   X     X X   X   X   X X     X   X     X     X X     X   X X         X X   X X   X         X
X X X X XXXXXXX X X XXX XXXXX X XXXXXXXXXXX XXXXX XXX X X XXXXXXX X XXX XXXXXXX X XXX X XXX XXXXXXXXX
X X   X   X   X   X   X     X         X   X X     X X X X       X   X   X X     X X   X X   X       X
X XXXXXXX X XXXXXXX X X X XXXXXXXXXXX X XXX X XXXXX X X XXXXXXX XXXXX XXX X X X X XXX X X XXX XXXXX X
X X   X   X     X   X X X X         X X     X X   X   X   X   X X   X   X X X X X X   X   X   X     X
X X X X XXXXX XXX XXX X X X XXX XXXXX XXXXXXX X X X XXX X XXX X X X X X X X X X X X X XXXXXXX XXX XXX
X   X   X   X   X X   X X X X X X   X X       X X X   X X   X X X X   X X X X X X X X       X   X X X
X XXXXXXX X X X X X XXX X X X X X X X X XXXXXXXXX XXX XXXXX X X X XXXXX X X X XXX X XXXXXXX XXX X X X
X       X X X X   X X   X   X X X X   X     X       X X   X X X X X   X X   X   X X     X X   X X X X
XXXXXXX X X XXXXXXX X XXXXXXX X X XXXXXXXXX X X XXXXX X X X X X XXX X X X XXXXX X XXXXX X XXX X X X X
X         X         X         X             X X         X   X       X   X     X         X       X   K
XXXXXXXXXXXXXXXXXXXXXXXXXXXXXXXXXXXXXXXXXXXXXXXXXXXXXXXXXXXXXXXXXXXXXXXXXXXXXXXXXXXXXXXXXXXXXXXXXXXXX
