XXXXXXXXXXXXXXXXXXXXXXXXXXXXXXXXXXXXXXXXXXXXXXXXXXXXXXXXXXXXXXXXXXXXXXXXXXXXXXXXXXXXXXXXXXXXXXXXXXXXX
P   X     X     X     X     X             X       X           X           X           X             X
X X XXX X X XXXXX X X XXX X XXXXXXXXXXXXX X XXX X XXX XXXXXXX X XXXXX XXXXX XXX XXXXX X XXXXXXX XXX X
X X     X   X     X X X   X X   X       X   X X X   X   X   X X     X       X   X   X X X       X   X
X XXX XXXXXXX XXXXX X X XXX X X X XXXXX X XXX X XXX XXX X XXX XXXXX XXXXXXXXX XXX XXX X X XXXXXXX XXX
X X   X     X X X   X   X X   X X   X   X     X   X     X   X X   X   X     X   X     X X X     X X X
X XXX X XXX X X X XXXXXXX XXXXX XXX X XXXXXXX XXX XXXXXXX X X X X XXX XXX XXXXX XXXXX X X XXX X X X X
X   X X   X X   X X           X     X       X   X     X   X     X   X   X     X     X X X   X X X   X
X X XXXXX X XXX X XXX XXXXX XXXXXXXXXXXXXXX XXX XXXXX XXXXX XXXXX XXXXX XXX X XXXXX XXX XXX X X XXX X
X X X     X   X X   X     X X         X     X   X   X     X X   X X   X   X X     X       X X X X   X
XXX X XXXXX X X XXX XXXXX X X X XXXXXXX XXXXX XXX XXXXXXX XXX X X X X XXX XXX XXX XXXXXXXXX XXX X XXX
X   X X   X X X   X   X   X   X     X   X   X     X       X   X X X X   X X   X     X   X   X   X   X
X X X XXX X XXXXX XXX XXXXX XXXXXXX X XXX X XXXXX X XXXXXXX XXX XXX XXX X X XXXXXXXXX X X XXX XXXXX X
X X X     X     X   X     X X     X   X   X     X X     X     X   X   X   X     X     X X X X   X   X
X X XXXXX XXX X XXX XXXXX X XXXXX XXXXXXX XXXXX XXXXXXX X XXXXXXX XXX XXXXX XXX X XXXXX X X X X X XXX
X X   X   X   X   X X     X         X     X     X     X     X   X   X   X     X     X   X X X X   X X
X X XXX XXX X XXXXX X XXX XXXXXXXXX X XXX XXXXX X XXX X XXXXX X X X XXX XXXXXXXXXXXXX X X X X XXXXX X
X X X   X X X X     X X   X     X   X   X X   X   X X X   X   X   X X X         X     X X X X X     X
X XXX XXX X XXX XXXXX XXXXX XXX XXX XXX XXX X XXXXX X XXXXX XXXXXXX X XXXXXXXXX X XXXXX X X X XXX X X
X X   X   X     X   X     X X X   X   X X   X     X X X     X   X X X         X   X   X X X     X X X
X X XXXXX XXXXXXX X XXXXX X X XXX XXX X X XXXXXXX X X X X XXX X X X X XXXXXXX XXXXX XXX X XXXXX X X X
X X     X   X   X X X   X       X X     X X     X X     X X   X X   X   X   X     X     X     X   X X
X XXXXX X X X X X X X X XXXXXXXXX XXXXXXX XXX XXX XXXXXXXXX XXX X XXXXX X X XXXXX X XXXXXXXXX XXXXX X
X     X X X X X   X   X           X     X   X   X           X X X       X X       X X X       X   X X
X XXXXX X XXX XXXXXXXXXXXXXXXXXXX X XXX XXX X X XXXXXXXXXXXXX X XXXXX XXXXXXX XXXXX X X XXXXXXX XXX X
X       X   X   X                 X X X     X X             X X     X X     X     X X X   X         X
X XXXXXXXXX XXX XXXXXXXXXXXXXXXXXXX X XXXXXXX XXXXXXXXXXX X X XXXXX XXX XXX XXXXX X X XXX XXX XXXXXXX
X X           X   X         X     X     X     X       X   X       X   X   X   X   X X   X   X X     X
X X XXX XXXXX XXX X XXXXXXX X XXX XXXXX XXXXX X X XXXXX XXXXX XXXXXXX XXX XXX X XXX X X XXX X X XXX X
X X   X     X   X       X   X X       X     X   X X     X     X     X   X X X X X   X X   X X X X   X
X XXXXXXXXX XXXXXXXXX XXX X X X XXXXX XXXXX XXXXXXX XXXXXXXXXXX X XXXXX X X X X X XXX XXXXX X X XXX X
X         X X     X   X   X X X   X     X   X     X       X     X X   X X   X X X     X     X X   X X
XXXXXXXXX X X XXX XXX X XXX X XXX X XXXXX XXX XXX XXXXX X X XXXXX X X X XXX X X XXXXX X XXXXX X X XXX
X       X X X   X   X X X   X X X X X     X   X       X X   X   X   X X     X X   X X X   X X X X   X
X X XXXXX X XXX XXX X X X XXX X X XXX XXXXX XXXXXXXXX X XXXXXXX XXXXX XXXXXXX XXX X X XXX X X XXXXX X
X X         X   X X X X X   X X X     X     X       X X         X   X       X   X   X   X X         X
X XXXXXXXXXXX XXX X X X XXX X X XXXXXXX XXXXX XXXXX X XXXXXXXXX X XXXXXXX X XXX XXX XXX X XXXXXXXXX X
X         X   X X   X X X   X     X   X       X     X       X   X X     X X X   X X   X X   X X     X
XXXXXXXXX X XXX X XXXXX X XXXXXXX X XXX XXXXXXX XXXXXXXXXXX XXX X X XXX XXX X XXX X XXX XXX X X XXXXX
X     X   X X   X X   X X       X X   X       X   X X     X   X   X   X     X   X   X   X   X X   X X
X XXXXX XXX X XXX X X X XXXXXXX X XXX XXXXX XXXXX X X X XXXXX XXXXXXX XXXXX XXX X XXX XXX XXX XXX X X
X       X   X     X X X       X X   X     X X     X X X     X   X     X     X   X X   X   X     X   X
X XXXXXXX XXX XXXXX X XXXXXXX XXXXX X XXXXX X XXXXX X XXXXX XXX X XXXXX XXXXX XXXXX XXX XXX X XXXXX X
X     X   X X X     X       X X     X     X X X   X   X   X X   X X   X X X   X   X X   X   X     X X
XXXXX X XXX X XXX XXXXXXXXX X X XXXXX XXX X X X XXX XXX XXX X XXX X X X X X X X X X X XXXXXXX XXX X X
X   X X   X   X   X         X X     X   X   X X   X X   X   X X     X X X X X X X   X       X X   X X
X X XXXXX X XXX XXX XXXXXXX X XXXXX XXXXX XXX X X X X XXX X X X XXXXX X X X XXX XXXXXXXXXXX X X X X X
X X       X   X   X X     X       X     X X   X X   X   X X X X X   X X   X   X       X   X X X X X X
X XXXXXXXXXXX X X XXX XXX XXXXXXXXXXXXX XXX XXX XXXXX X X XXX X X X X XXXXXXX XXXXXXX X XXX X X XXX X
X           X X X X   X   X   X       X     X X     X X X   X X X X X   X   X       X X X   X X     X
X XXXXXXXXX X XXX X XXX XXX X X XXXXX XXXXXXX XXXXX X X XXX X X X X XXX X X X XXXXX X X X XXX XXXXXXX
X X       X X   X X   X   X X   X     X         X   X X   X X X X X X   X X X X   X     X   X X     X
X X XXXXX X XXX X XXX XXX X XXXXX XXXXX XXXXXXX X XXX X XXX X XXX X X XXX X XXX X XXXXX XXX X XXX X X
X X   X X   X   X   X X   X   X   X     X   X   X X   X   X   X   X X X   X     X     X   X X   X X X
XXXXX X XXXXX XXX XXX X X XXX X XXX XXXXX X X X X X XXXXX XXXXX XXX X X XXXXXXXXXXXXX XXX X XXX X XXX
X     X     X X   X   X X X   X   X   X X X   X X X   X   X     X X   X X       X   X X   X   X X   X
X XXXXX X XXX XXX X XXX XXX XXXXX XXX X X XXXXX X XXX X XXX X XXX XXX X X XXX XXX X X XXXXXXX X XXX X
X X     X   X     X X X     X   X   X X X   X   X   X X     X X       X X   X     X X X       X   X X
X X XXXXXXX XXXXX X X XXXXXXX X XXX X X XXX X XXXXX XXXXX XXX X XXXXXXX XXXXXXXXX X X X XXXXXXXXX X X
X X X     X   X   X X   X     X   X   X X   X     X X   X X   X   X     X       X X   X X X   X   X X
X X X XXXXX XXX XXX X XXX XXXXX X XXXXX X XXXXXXX X X X XXX XXXXX X XXX X XXXXX X XXXXX X X X X XXX X
X X   X   X       X X         X X X     X       X X   X   X X     X   X X   X X X   X   X X X   X   X
X XXX X X X XXXXXXX XXXXXXXXXXX X XXX X XXXXXXX X XXXXXXX X XXXXXXXXX XXXXX X X XXX X XXX X XXXXX X X
X   X X X X X     X   X     X   X     X X   X   X       X X X       X     X   X   X X   X   X   X X X
XXX X X X XXX XXX XXX X XXX X XXXXXXXXX X XXX XXXXX XXXXX X X XXXXX XXXXX XXX XXX X X X X XXX X X X X
X   X X X   X X X     X   X   X       X X   X X     X   X X   X X       X     X   X X X X X   X   X X
X XXXXX XXX X X XXXXXXXXX XXXXX XXX XXX XXX X X XXXXX X X X XXX X XXXXXXXXXXXXX XXX XXX X X XXXXXXX X
X     X X X   X X         X   X   X X   X   X X     X X   X     X       X     X X X   X X X   X     X
X XXX X X XXXXX X XXX XXXXX XXX X XXX XXX X X XXXXXXX XXXXXXXXX XXXXXXX X XXX X X XXX X X XXXXX XXX X
X X X   X           X X X   X   X     X   X X         X         X     X   X   X X X     X       X X X
X X XXXXXXX XXXXXXXXX X X X X XXXXXXXXXXX X XXXXXXXXXXXXXXX XXXXXXX XXXXX X X X X X XXXXXXXXXXXXX X X
X X       X       X   X X X   X   X       X         X     X         X   X X X X X   X     X       X X
X XXX XXX XXX XXXXX XXX X XXXXX X X X XXXXXXXXXXXXX XXX X XXXXXXXXXXX X XXX X X X XXX XXX X XXXXXXX X
X   X   X X   X     X   X X   X X X X X   X       X   X X             X     X X X X     X X     X   X
XXX XXX X XXXXX XXXXX X X X X X X X X XXX X XXX X XXX X XXXXXXXXXXXXXXXXXXXXX X XXX XXXXX X XXX X XXX
X X     X   X   X   X X   X X   X X X X   X X X X   X   X   X                 X       X   X X X X   X
X XXXXXXXXX X XXX XXX XXXXX XXXXX XXX X XXX X X XXX XXXXX XXX XXXXXXXXXXXXXXX XXXXXXXXX XXX X X XXX X
X X       X   X     X       X   X     X X   X X   X     X   X         X     X   X   X   X     X   X X
X X XXX XXXXXXXXXXX XXXXXXXXXXX XXXXXXX X XXX XXX XXXXX X X XXXXXXXXX X XXX XXX XXX X XXXXXXX X XXX X
X X X X             X         X         X       X   X   X X   X     X X   X X     X X X     X X   X X
X X X XXXXXXX XXXXX XXX XXXXX XXXXX XXX XXXXXXX XXX X XXX XXX X X XXX XXX X XXXXX X X X XXX XXXXX X X
X   X       X   X X     X         X X     X     X   X   X X X   X     X   X   X     X X   X   X   X X
X XXX XXXXX XXX X XXX XXXXXXXXXXX X XXXXX X XXXXX XXXXX X X XXXXXXXXXXX XXXXX XXXXXXX X X XXX X XXX X
X   X     X X X X     X         X X     X X   X X   X   X X           X X   X   X     X X X     X   X
XXX XXXXX X X X X XXXXX XXXXXXX X XXXXX XXXXX X XXX XXXXX XXXXXXX XXX X X X XXX X XXXXX X XXXXXXX XXX
X   X     X   X X   X   X     X X     X   X   X   X     X         X   X   X X X   X     X   X     X X
X XXX XXXXXXXXX XXXXX XXX XXXXX XXXXX XXX X XXX XXXXXXX XXXXXXX XXXXXXXXXXX X XXXXX XXXXXXX X XXXXX X
X X     X   X   X     X       X   X       X     X   X     X     X   X       X   X   X X   X   X     X
X X XXX X X X XXX XXXXX XXXXX XXX XXXXXXXXXXX XXX X X XXXXX XXXXX X X XXXXXXX XXX XXX X X XXXXX XXXXX
X X   X X X   X   X   X X X     X             X   X X     X X     X X X   X   X   X   X X   X       X
X XXXXX X XXX X XXX X X X X XXX XXXXXXXXXXXXXXX XXX XXXXX X X XXXXX X X XXX X X XXXXX X XXX X XXXXX X
X       X   X X X X X X   X   X X   X     X   X X X X   X   X X   X   X     X   X   X     X   X X   X
XXXXXXX XXX XXX X X X XXX XXX XXX X X X XXX X X X X X X XXXXX X X XXXXX XXXXXXXXX X XXXXXXXXX X X XXX
X X     X X     X   X     X   X   X X X     X X X     X     X   X X     X   X     X         X   X   X
X X XXXXX XXXXXXXXXXXXXXXXX XXX XXX X XXXXXXX X XXXXXXXXXXX XXXXX X XXXXX X X XXXXXXXXXXXXX XXX XXX X
X   X   X                 X       X X X X     X         X         X X     X   X         X   X   X   X
X XXX XXX XXXXX XXXXXXXXX X XXXXXXX X X X XXX XXXXXXXXX XXXXXXXXXXX XXX XXX XXXXXXXXX XXX XXXXX X XXX
X X X     X   X X   X   X X X     X X   X   X     X   X   X       X   X   X X       X     X   X X   X
X X X XXXXX X X X XXX X X XXX XXX X XXX XXX XXXXXXX X XXX XXX XXXXXXX X X X X XXXXX X XXXXX X XXXXX X
X X       X X   X     X X   X   X     X X X   X     X   X X   X       X X X X     X X X X   X     X X
X XXXXXXXXX XXX XXXXX X XXX XXX X XXXXX X XXX X XXXXXXX X X X X XXXXXXXXX XXX XXXXX X X X X XXXXX X X
X         X   X X   X X         X X     X   X X X     X   X X X X       X     X     X X   X X X   X X
XXXXXXXXX X X XXX X XXXXXXXXXXXXX X XXXXX XXX X X X XXXXXXX XXX X XXXXX XXXXXXX XXXXX X XXX X X XXX X
X     X   X X     X   X   X   X X X X     X   X X X X       X   X X   X     X   X     X   X X   X   X
X XXXXX XXXXXXXXXXXXX X X X X X X X X XXXXX XXX X X X XXXXX X XXX X X XXXXX X XXXXXXX XXXXX X XXX XXX
X X     X   X       X X X   X X   X   X     X   X X X X   X X     X X X     X   X   X       X   X   X
X X XXXXX X X XXXXX X X XXXXX XXX XXX X XXXXX XXXXX X X XXX XXXXXXX X X XXXXXXX X X XXXXXXXXXXX XXX X
X X X     X X   X     X X   X   X   X X X     X     X X   X       X X X     X   X X       X   X   X X
X X X X XXX X X XXXXX X XXX XXX XXXXX X X XXXXXXX X X X X XXX XXXXX X XXXXX X XXX XXXXXXX X X XXX X X
X X X X X X X X X   X X   X   X   X   X X X   X   X X X X   X       X         X         X   X   X X X
X X XXX X X X X X X X XXX X X XXX X XXX X X X X XXX X X X X XXXXXXXXXXXXXXXXXXX XXXXXXX XXXXXXX X X X
X X     X   X X X X X   X X X X   X   X X X X   X   X X X X X   X X       X       X   X X     X X X X
X XXXXXXX XXX X X X XXX X XXX X X XXX X X X XXXXXXXXX X X X X X X X XXXXX X XXXXXXX X X X XXX X X X X
X   X   X X   X   X   X X   X X X X   X X X   X     X X X X X X   X X   X   X       X X X X   X X X X
X XXX X X X XXXXXXXXX X XXX X X XXX XXX X X X X XXX X XXX X X XXXXX XXX XXXXX XXXXXXX X X XXX X X X X
X X   X   X     X     X X X X X       X X X X   X   X     X   X     X X     X X       X X   X X X   X
X X XXXXXXX XXXXX XXXXX X X X XXXXXXXXX X X XXXXX XXXXXXXXXXX X XXXXX XXXXX X X XXXXXXX XXX X X XXXXX
X X   X     X   X X   X   X       X X   X X X   X X         X X   X       X   X       X     X X     X
X XXX X XXXXX X X X XXX XXXXXXXXX X X X X XXX X X X XXX XXXXX XXX X X XXX XXXXXXXXXXX XXXXXXXXXXXXX X
X X   X   X X X   X     X       X X X X X X   X   X   X       X   X X X X     X     X X             X
X X XXXXX X X XXXXXXXXXXX XXXXX X X X XXX X XXXXXXX XXXXX XXXXX XXXXX X XXXXX XXX XXX X X XXXXXXXXX X
X   X   X   X             X   X     X   X X         X   X   X   X     X     X X   X   X X X   X     X
X XXXXX XXX XXXXXXXXXXXXXXX X XXXXXXXXX X XXXXXXXXXXX X XXX X XXX XXXXX XXXXX X X X XXX XXX X XXXXXXX
X X       X     X           X X         X             X X X X   X X       X     X X X       X       X
X XXX XXXXXXXXX XXX XXXXXXXXX X XXXXXXX XXXXXXXXXXXXXXX X X XXX X XXX XXX X XXXXXXX XXXXX XXXXXXXXX X
X   X X       X X   X         X X     X X           X   X     X X   X   X   X       X   X X       X X
XXX X X XXX XXX X XXXXXXXXXXXXX X XXX X XXXXXXXXXXX X XXXXX XXX XXX XXX XXXXX XXXXXXX X X X XXX XXX X
X   X X   X   X X X             X X X X           X X     X X   X   X X     X X       X X   X   X   X
X XXX XXX XXX X X X XXXXXXXXXXXXX X X XXXXXXXXXXX X XXXXX X X XXX XXX X XXXXX X XXXXXXX XXXXX XXX XXX
X X       X X     X X X   X       X     X       X X X     X X X   X     X   X X       X     X   X   X
X XXXXXXX X XXXXXXX X X X X XXX X XXXXXXX XXX XXX X X XXXXXXX X XXX XXXXX X X X XXXXX XXXXX XXX XXX X
X       X   X       X   X     X X X         X   X X X X     X   X X X X   X   X X     X   X X X X   X
XXXXXXX X XXX XXXXXXX XXXXXXXXX XXX XXXXXXXXXXX X X X X XXX XXXXX X X X XXXXXXXXX XXXXXXX X X X X XXX
X X     X X   X           X     X   X   X X     X X X   X X     X X   X   X     X X     X X X   X   X
X X XXXXX X XXX XXXXXXXXXXX XXXXX XXX X X X XXXXX X XXXXX XXX X X XXX XXX X X X X X XXX X X X XXXXX X
X X     X X X   X   X     X   X   X   X X X       X       X   X     X X X X X X X X   X   X X     X X
X XXXXX X X XXX X X X XXX XXX X XXX X X X XXXXXXXXX XXXXXXX XXXXXXX X X X XXX X X X X XXXXX X XXXXX X
X     X X X   X X X X X       X   X X X X   X     X   X     X X     X X X     X X X X       X X     X
XXX XXX X XXX XXX X X XXXXXXXXXXX XXX X X X X XXX XXX X XXXXX X XXXXX X XXXXXXX X XXX XXXXXXXXX XXXXX
X   X   X X X   X X X X         X   X X X X   X X     X X     X     X X     X   X   X           X   X
X XXX XXX X XXX X X X X XXXXXXX XXX X X X XXXXX XXXXX X X X XXXXXXX X X XXX X XXXXX XXXXXXXXXXXXXXX X
X     X X     X   X X   X         X   X   X         X X X X         X X X X X X     X       X   X   X
X XXXXX XXXXX XXXXX X XXX XXXXXXX XXXXXXXXX XXXXXXX X X XXXXXXXXXXXXX X X X X XXX XXX XXXXX X X X XXX
X X         X X X   X X   X   X X   X   X       X X X X               X   X X     X       X   X X   X
X X X XXX XXX X X XXX X XXX X X XXX XXX X XXXXX X X X XXXXXXXXXXXXXXXXXXX X XXXXXXXXXXXXX XXXXX XXX X
X X X X   X     X   X X   X X X   X X   X X   X X   X   X X       X     X X             X X   X   X X
X X X XXXXX XXXXXXX XXXXX X X X X X X XXX X X X XXXXXXX X X X XXXXX XXX X XXX XXXXXXXXX X X X XXX X X
X X X       X       X     X X X X X X   X X X X       X X   X     X   X X   X X   X       X X     X X
X XXXXX XXXXX XXXXXXX XXXXX X X X X XXX X X XXXXXXX XXX X XXXXXXX XXX X X XXX X XXX XXXXXXX XXXXXXX X
X     X     X   X     X X   X   X X     X X   X     X   X       X   X X   X   X     X   X       X   X
XXXXX XXXXX XXX XXX XXX X X XXXXXXXXX XXX XXX X XXX X XXX XXXXXXX XXX XXXXX X XXXXXXX X XXXXXXX XXX X
X   X   X X   X   X X   X X X         X       X   X X X   X     X   X X   X X X       X     X       X
X X XXX X XXX XXX X X XXX X X XXXXXXXXX XXXXXXXXX XXX X XXX XXX X X X XXX X X X XXXXXXXXX X XXXXXXX X
X X     X   X   X X X     X   X       X X X     X   X X X   X   X X X   X X X X   X X   X X X     X X
X XXXXXXX X XXX X X X XXXXXXXXXXX X XXX X X XXX XXX X X X XXX XXXXX XXX X X X XXX X X X XXX X XXX X X
X X   X   X   X X X X     X       X X   X X X       X X X X       X X   X X X   X   X X     X   X X X
X XXX X XXXXX X X X XXXXX X X XXXXXXX XXX X XXXXX XXX X X X XXXXX X X XXX X XXX XXX X XXXXXXXXX X X X
X   X X X   X   X X   X     X X     X X   X   X   X   X X X X   X X X   X X X   X   X X     X   X X X
XXX X X X X XXXXX XXX XXXXXXXXX XXX X XXX XXX XXX X XXX X XXX X X X XXX X X X XXX XXX X XXX X XXX X X
X   X   X X X   X   X           X   X     X X   X X X X X X   X X     X   X X X   X X     X     X X X
X XXX XXX X X X X X X XXXXXXXXXXX X XXXXX X XXX XXX X X X X XXX XXXXX XXX X XXX XXX XXXXX XXXXXXX X X
X   X   X X   X X X X   X     X   X X   X   X X     X   X   X X   X X   X X   X   X X   X   X     X X
XXX XXXXX XXXXX XXX XXX XXXXX X XXX X XXXXX X XXXXXXX XXXXXXX XXX X XXX X XXX XXX X X X XXX X XXXXX X
X X X   X X   X     X   X     X X     X   X X       X X       X   X X   X   X     X X X X   X X   X X
X X X X X X X XXXXXXX XXX X XXX XXXXXXX X X XXX XXX X X X XXX X XXX X XXXXX XXXXXXX X X XXXXX X X X X
X   X X X X X     X   X   X X   X       X X   X   X   X X   X X X         X   X     X X   X   X X X X
X XXX X X XXX XXXXX XXX XXX X XXX XXXXXXX XXX XXX XXXXXXXXX X X XXXXXXXXX XXX XXX X X XXX X XXX X X X
X     X   X   X     X   X   X       X     X X X X X       X X X       X   X       X X X   X   X X X X
XXXXXXXXXXX X X XXXXXXX X XXXXXXXXX X XXX X X X X XXX XXX X X XXXXXXX XXXXX XXXXXXXXX X XXXXX X XXX X
X   X       X X         X X     X   X X X   X X       X X X X   X   X     X X X       X       X   X X
X XXX X XXXXXXXXXXXXXXXXX X XXX XXXXX X XXX X XXXXXXXXX X X X XXX X X XXX X X X XXXXXXXXXXXXXXX X X X
X   X X             X     X X         X X   X   X           X X   X X   X     X   X       X   X X   X
X X X XXXXXXXXX XXXXX XXXXX XXXXXXXXXXX X XXXXX X XXXXXXXXXXXXX XXX XXXXXXXXXXXXX X X XXX XXX X XXXXX
X X X     X   X         X   X         X X X   X X X       X     X X               X X   X     X X   X
XXX XXXXX X XXXXXXXXXXXXX XXX XXXXXXX X X XXX X XXX XXXXX X XXXXX XXXXXXXXXXXXXXXXX XXX XXXXXXX X X X
X     X   X       X X     X   X     X X X   X X     X   X X X       X         X     X   X   X   X X X
X XXXXX XXXXXXX X X X XXXXX XXXXX XXX X XXX X XXXXXXX X X X XXX X XXX X XXXXX X XXXXX XXX X X XXXXX X
X X     X       X   X   X   X     X   X       X X     X   X   X X   X X   X   X X X   X   X   X     X
X X XXXXX XXXXXXXXX XXX X XXX XXX X XXXXXXXXX X X XXXXXXXXXXX X XXX X XXX XXXXX X X XXX XXXXXXX XXX X
X X X     X   X       X X     X X X         X   X     X X     X X X     X         X     X       X X X
X X XXXXX X X X XXXXXXX XXXXXXX X XXXXXXXXX XXXXXXXXX X X X XXX X XXXXXXXXX XXXXXXX XXXXXXX XXX X X X
X   X   X X X     X     X X     X X       X           X   X X X     X     X X     X   X   X X   X   X
X XXX X X XXXXXXXXX XXX X X XXX X XXXXXXX XXXXXXXXXXXXX XXX X XXX XXX XXX XXX XXX XXX X X XXX XXX XXX
X     X   X       X X X   X X   X       X X   X       X   X X     X     X     X   X X   X   X   X   X
XXXXXXX XXX XXXXX X X XXX X X XXXXXXXXX X X X X XXX XXX XXX XXXXXXX XXXXXXXXXXX XXX XXXXXXX XXX XXX X
X     X X   X   X X X     X X           X   X   X X X   X   X     X   X         X         X X   X   X
X XXX XXX XXXXX X X XXXXX X XXXXXXXXXXXXXXXXXXX X X X XXX X X XXX XXX X XXXXXXXXXXXXXXX X X X XXX XXX
X   X X   X     X X     X X     X         X   X   X X X X X X   X     X     X   X       X X   X   X X
XXX X X XXXXX XXX XXX X XXXXXXX XXXXX X X X X XXX X X X X X XXX XXXXXXXXXXX X X X XXXXXXX XXXXX XXX X
X   X   X   X       X X     X X     X X X   X X X X X X X X X   X     X     X X X   X     X     X   X
X XXXXX X X XXXXXXX XXXXX X X XXXXX XXX XXXXX X X X X X X X X XXX XXXXX XXXXX X XXX X XXXXX XXXXX X X
X X     X X     X X       X X     X     X   X X   X     X X X X   X     X     X     X   X   X   X X X
X XXXXXXX XXXXX X XXXXXXXXX X XXXXXXXXXXXXX X X XXXXXXXXX XXX X XXX XXXXXXX XXXXXXXXX XXX XXX X XXX X
X         X   X X     X     X X             X X   X X     X     X   X     X   X     X X   X   X     X
X XXXXXXXXX XXX XXXXX X XXXXX X XXX XXXXXXXXX XXX X X XXXXX XXXXX XXXXX X XXX X XXX XXX XXX XXXXXXXXX
X     X     X   X     X       X X X X         X     X     X   X   X   X X     X X X     X           X
XXXXX X X XXX XXX XXXXXXXXX XXX X X X XXXXXXXXXXXXXXXXX X X XXX XXX X X XXXXX X X XXXXXXX XXXXXXXXX X
X       X X   X   X       X X   X X X X               X X X X   X   X   X     X         X X         X
XXXXXXXXXXX XXX X X XXXXX X X XXX X X XXXXXXXXX XXXXX XXX X X XXX XXXXXXX XXXXXXXXXXXXX XXX XXXXXXX X
X         X   X X X   X   X X     X   X   X     X   X   X   X X   X   X X X       X   X   X   X     X
X XXXXXXX XXX X X XXX X XXX XXXXX XXXXX X X XXXXX XXXXX X XXX X X X X X X X X XXXXX X XXX X X XXX XXX
X   X   X     X X X X X     X   X   X   X   X   X       X X X X X   X X   X X X     X   X X X   X   X
X X XXX XXXXXXX X X X XXXXXXXXX XXX XXX XXXXX XXX XXXXXXX X X XXXXXXX XXXXX X X XXXXXXX X XXXXX XXX X
X X   X         X   X X     X   X X     X   X     X     X   X       X   X   X X X   X   X X   X X   X
XXXXX X XXXXXXXXXXX X XXX X X X X XXXXXXXXX X XXXXX XXXXXXX XXXXXXX XXX X XXX X X XXX X X X X X X XXX
X     X   X   X     X     X   X X     X   X X X   X           X     X   X X X   X X   X X   X   X   X
X XXXXX X X X X XXXXXXXXXXXXXXX X XXX X X X X X X X XXXXXXXXXXX XXXXX XXX X XXXXX X XXXXXXXXXXXXXXX X
X X     X   X X X       X     X X   X   X   X X X   X           X       X   X     X       X     X   X
X XXXXXXXXXXX XXX X XXXXX X X X XXX XXXXXXX X XXXXXXX XXXXXXXXXXXXX XXX XXX XXX X XXXXX X XXXXX X XXX
X   X       X X   X X     X X X     X     X X       X       X     X X   X X   X X   X X X       X X X
X X X XXXXX X X XXX X XXXXX XXX XXXXXXXXX X XXXXXXX XXXXXXX X XXX XXX X X XXX XXX X X X XXXXXXX X X X
X X       X X X X X       X     X       X   X     X X       X X       X     X     X   X   X   X X   X
X XXXXXXXXX X X X XXXXXXX XXXXXXX XXXXX X XXX X XXX X XXXXXXX XXXXXXXXXXXXX XXXXXXXXX XXX XXX X XXX X
X X X       X X   X     X X       X   X X X   X X   X   X     X   X           X   X   X X   X X X   X
X X X XXXXXXX X XXX XXX X X XXXXXXX X X X X XXX X XXX X X XXX X X XXXXXXXXXXX X XXX XXX XXX X X X XXX
X   X   X   X   X   X X X X     X   X X X X X X   X   X X X   X X   X       X   X   X     X X   X X X
XXXXXXX X XXX XXX XXX X XXXXXXX X XXX X XXX X XXXXXXXXX X X XXX XXX X XXXXX X XXX XXX XXX X X XXX X X
X       X       X X   X X     X X   X X     X   X       X X X   X X   X     X X   X     X X X X   X X
X XXXXXXXXXXXXXXX X XXX X XXX X X X X XXXXXXX X XXX XXXXX X X XXX XXXXX XXXXXXX XXXXXXX X X XXX XXX X
X         X       X   X   X X   X X X X   X   X   X X   X X   X   X   X       X X   X   X X X   X   X
X XXXXXXX X XXXXXXXXX XXXXX XXXXXXX X X X X XXXXX X X XXX XXXXX X X X XXXXXXX X X X X XXX X X XXXXX X
X       X                           X   X   X       X           X   X       X     X   X   X         K
XXXXXXXXXXXXXXXXXXXXXXXXXXXXXXXXXXXXXXXXXXXXXXXXXXXXXXXXXXXXXXXXXXXXXXXXXXXXXXXXXXXXXXXXXXXXXXXXXXXXX
