XXXXXXXXXXXXXXXXXXXXXXXXXXXXXXXXXXXXXXXXXXXXXXXXXXXXXXXXXXXXXXXXXXXXXXXXXXXXXXXXXXXXXXXXXXXXXXXXXXXXX
P             X     X     X   X     X   X       X     X       X           X         X       X       X
X X XXXXXXXXX X XXX XXX X X X X XXX X X XXXXX X X XXX XXX XXX X X XXXXXXX X X XXXXX X XXXXX X XXXXX X
X X         X X   X X   X   X   X X X X X     X X X X   X X   X X   X     X X   X   X X   X       X X
X XXXXXXXXX X XXX X X XXXXXXXXXXX X X X X XXXXX X X XXX XXX XXX XXX XXXXX X XXX X XXX X XXXXXXX XXX X
X     X     X   X X X   X   X     X   X X     X X X   X   X X   X   X   X X   X X   X X X     X X   X
XXXXXXX XXXXXXX X X XXX X X X X X XXXXX X XXX X X X X XXX X X XXX XXX X XXXXX X XXX X X X XXX XXX XXX
X       X X   X   X     X X X X X   X   X   X X   X X     X X X X   X X       X   X X   X   X     X X
X XXXXXXX X X X XXXXXXXXX X XXX XXX X XXX XXX XXXXX XXXXXXX X X XXX X XXXXXXXXX X X XXX XXX XXXXXXX X
X   X     X X   X         X   X X   X   X X   X       X   X X X   X   X X     X X X   X X X X       X
X X X XXX X XXXXX XXXXXXXXXXX X XXXXXXX X X XXXXXXXXX X X X X XXX XXXXX X XXX X X XXX X X X XXX X XXX
X X X X   X     X         X   X X   X   X X       X X   X   X         X X X   X X   X X   X   X X   X
XXX X XXXXXXX XXXXXXXXX XXX XXX X X X XXXXXXX XXX X XXXXXXX XXXXXXXXX X X X XXX XXX XXXXX XXX XXX X X
X   X X       X     X   X   X     X         X   X X     X   X   X X     X X X     X   X   X X   X X X
X XXX X XXXXXXX X XXX XXX XXXXXXXXXXXXXXXXX XXX X X XXX X XXX X X X XXXXX X XXXXXXXXX X XXX XXX X X X
X   X X X   X   X X   X X   X       X         X X X   X   X   X X X X X   X X       X     X X   X X X
X X X X XXX X XXX X XXX XXX X XXXXX XXXXXXXXX XXX XXXXXXX X XXX X X X X XXX X XXXXX XXXXX X X XXXXX X
X X X     X X   X X       X X X   X         X   X   X   X   X     X   X X X X X   X   X     X   X   X
X X XXXXX X XXX X XXXXXXX X X X X XXXXXXXXX XXX X X X X XXXXXXXXXXXXX X X X X X XXXXX XXXXX XXX X X X
X X     X   X   X     X X X X   X   X     X   X X X   X X             X X X X X X         X   X X X X
X XXXXX XXX X XXXXX X X X X XXXXXXX X XXX XXX X XXXXXXX X XXXXXXXXXXXXX X X X X X XXXXXXX XXX X X X X
X   X X   X X X   X X   X X       X   X X   X X         X   X     X   X X     X   X     X   X X X X X
XXX X XXX X X X XXX XXXXX XXX X XXXXXXX XXX X XXXXXXXXX XXX X XXX XXX X X XXXXXXXXX XXX XXX XXX X XXX
X   X X   X X X   X       X   X X         X X       X X   X X   X X   X X X   X   X   X X X     X   X
X XXX X X XXX X X XXXXXXXXX X XXX X XXXXXXX XXXXXXX X X XXX XXX X X X X XXX X X X X XXX X XXXXXXXXX X
X X   X X X   X X     X X   X X   X       X X     X X   X   X   X   X X     X   X   X   X         X X
X X X X XXX XXX XXX X X X XXXXX XXXXX XXX X XXX X X XXXXX XXX X XXXXXXXXXXX XXXXXXXXX XXX X XXXXX X X
X   X X     X   X   X   X X     X   X X   X X   X X     X X   X X         X   X   X   X   X   X   X X
XXXXX XXXXXXX XXX XXXXX X X XXXXX X XXX XXX X XXX XXXXX X XXX XXX XXXXXXX XXX XXX X XXX XXXXX X XXX X
X     X   X     X     X X   X X   X   X   X   X       X X X   X   X   X   X       X X X X X   X     X
X XXXXX XXX XXXXXXX X XXXXXXX X XXXXX XXX XXX XXXXXXXXX X X X X XXX X X XXXXXXX XXX X X X X XXXXXXXXX
X   X   X   X     X X         X     X   X X   X       X     X X   X X X     X   X   X X   X         X
XXX X XXX XXX XXX XXXXXXX XXXXXXXXX XXX X X XXX XXXXX XXXXXXXXXXX X XXXXXXX XXXXX XXX XXX XXXXXXXXX X
X X X       X   X     X   X       X   X   X X X X   X             X       X       X     X   X     X X
X X XXXXXXXXX X XXXXX X X X XXX XXXXX XXXXX X X X X XXXXXXXXXXXXXXX XXXXX XXXXXXXXXXX X XXX XXX X X X
X X     X   X X X   X X X X   X     X X       X X X   X       X   X   X X             X   X     X X X
X XXXXX X X XXX X X X X XXXXX XXX X X X XXXXXXX XXX XXX X XXX X X XXX X XXXXXXXXX XXXXX XXXXXXXXX X X
X     X X X   X   X X X     X X X X X X X     X   X     X X   X X X   X X       X X     X     X   X X
X XXXXX X XXX XXXXX X XXXXX X X X X X X X XXX XXX X XXXXX X XXX XXX XXX X XXX XXX X XXXXX X XXX XXX X
X   X   X   X   X   X     X     X X X X X   X   X X     X X X   X   X   X   X   X X   X X X     X   X
XXX X XXXXX XXX X XXXXXXX XXX XXX X X X XXX XXX X X XXXXX X XXX X XXX XXX XXXXX X XXX X X XXXXXXX X X
X   X X     X     X     X   X X   X X     X   X   X X     X   X X X       X     X X     X X     X X X
X XXX X XXXXXXXXXXXXX XXXXX X X XXXXXXX XXXXX XXXXXXX XXXXXXX X X XXXXXXXXX XXX X XXXXXXX XXXXX X X X
X X   X X       X   X X     X X X     X X     X       X     X X X X         X   X X     X       X X X
X X XXX X XXXXX X X X X XXXXXXX X XXX XXX XXXXX XXXXXXX XXX X X X X XXXXXXXXX XXX X XXX XXX XXXXX X X
X   X     X   X   X X   X       X X X   X     X     X   X   X   X   X   X   X X X X X X     X   X X X
X XXXXXXXXX X XXXXX XXX X XXXXX X X XXX X XXX XXX X X XXX XXX XXX XXXXX X X X X X X X XXXXXXX X X XXX
X           X     X   X X   X   X X   X X X X   X X     X X X X   X   X   X     X         X   X X   X
XXXXXXXXXXXXXXXXX XXX X X X XXX X X XXX X X XXX X XXXXX X X X X XXX X XXXXXXX XXXXX XXXXXXX XXX XXX X
X   X     X     X     X X X   X X X X   X     X X X   X X X X X X X X       X X   X X   X   X X   X X
XXX X X X X XXX XXXXXXX X XXX X X X X XXXXXXXXX XXX X XXX X X X X X XXXXXXX XXX X X X X X XXX XXX X X
X   X X X X   X   X   X X X   X X   X   X     X     X X   X   X   X X   X       X X X X X X     X   X
X XXX X XXXXX XXX X X X X X XXX XXX XXX X XXX XXXXX X X XXXXX X XXX X X X XXXXXXX XXX X X X X XXXXX X
X X   X   X   X X   X X X X X X X X X X   X   X   X X X     X X X   X X   X   X       X X X X X     X
X X XXXXX X XXX XXXXX X X X X X X X X XXXXX XXXXX X X X XXX X X X XXXXX XXX X XXXXXXXXX X X X X XXXXX
X X X X   X     X   X X X X X X   X X   X X       X X X X   X X X     X   X X     X   X   X X   X   X
X X X X XXXXXXX X X X X XXX X XXX X X X X XXXXXXXXXXX X X XXXXX XXXXX X XXX XXXXX XXX XXXXX XXXXX X X
X   X X     X   X X   X     X     X   X   X           X X   X   X   X X X   X   X   X     X   X   X X
X XXX XXXXX X XXX XXX XXXXXXX XXXXXXXXXXX XXXXXXXXX XXX XXX X XXX XXX XXX XXX XXXXX XXX X XXX XXXXX X
X X       X     X X   X     X X   X   X   X   X     X   X   X   X X   X   X X     X   X X   X       X
X XXXXXXX XXXXXXX X XXX XXX X X X XXX X XXX X X XXXXX XXX X XXX X X XXX XXX X X XXXXX X XXXXXXXXXXX X
X   X     X     X X     X   X X X     X     X   X   X X X X   X X X     X     X X     X     X     X X
XXX X XXX X XXX X XXXXXXXXXXX X XXXXXXXXXXXXXXXXX XXX X X XXXXX X XXXXXXX XXXXX X XXXXX XXX X X XXX X
X X   X X X X     X       X   X     X   X     X       X X X     X     X   X   X X X   X X X   X     X
X XXXXX X X X XXXXX XXXXX X XXXXXXX X X X XXX X XXXXXXX X X XXXXX XXXXX XXX X X X X X X X XXXXXXXXXXX
X X     X X X X     X   X X   X   X   X   X X X X       X   X             X X   X X X       X       X
X X XXX X X XXX XXXXX X X XXX X X XXXXXXX X X X XXXXX X XXXXXXXXXXXXXXXXX X XXX X XXXXXXXXXXX XXXXX X
X X X X   X   X       X X     X X   X   X   X X X     X     X         X   X   X X X           X   X X
X X X XXXXXXX XXXXXXXXX XXXXXXX XXX X X XXX X X X X XXXXXXX X X XXXXX XXXXXXX X X X XXXXXXXXXXX X X X
X X   X   X           X X       X X   X   X X     X X   X     X X   X         X X X   X   X     X X X
X XXX XXX X XXXXXXXXX X XXX XXXXX XXXXXXX XXXXXXXXXXX X XXXXXXXXX X XXXXXXXXXXX X XXX X X X XXXXX X X
X   X   X X X     X   X     X   X       X   X         X           X   X     X   X   X X X   X   X   X
X X XXX X X X XXX XXXXXXXXXXXXX X X XXXXXXX X XXXXXXXXXXXXXXXXXXXXXXX X XXX XXXXXXX X X XXX X X XXX X
X X   X X X   X X   X         X X X   X   X   X               X     X   X X     X   X X   X X X X X X
X XXX X X XXXXX XXX X X XXXXX X X XXX X X XXXXXXXXXXXXX XXXXX XXX X XXXXX XXXXX X X X XXX XXX X X X X
X X X X X         X X X X   X   X X X   X       X   X   X       X X   X         X X X X X     X X   X
X X X X X XXX XXXXX X X X X XXXXX X XXXXXXX XXX X X X X XXXXXXX XXXXX X XXXXXXXXX XXX X XXXXXXX X XXX
X   X   X X X   X   X X X X     X   X       X   X X   X X     X       X X   X   X   X X     X   X   X
XXX XXXXX X XXX X XXX X X XXXXX XXX X XXXXXXX XXX XXXXXXX XXX XXXXXXX X X X XXX X X X X XXX X X XXXXX
X   X         X X   X X X X   X   X X X           X         X       X X   X   X   X     X   X X X   X
X XXXXXXXXXXXXX XXX X X X X X X XXX X X XXXXXXXXXXX XXXXXXXXXXX XXX XXXXXXXXX X XXXXXXXXX XXX X X X X
X X               X   X X X X X     X X   X             X     X X   X         X X       X   X X X X X
X XXX XXXXXXXXX XXXXXXX X XXX XXXXXXX XXXXX XXXXXXXXXXXXX XXX X X XXX XXXXXXXXX X XXXXX XXXXX XXX X X
X   X   X     X X     X X       X   X   X   X   X         X X X X X   X   X   X X     X     X     X X
XXX X X X XXXXX X X XXX XXXXXXX XXX XXX X XXX X X XXXXXXXXX X XXX X XXX X X X X XXXXX XXXXX XXXXX X X
X X X X X       X X   X       X       X X     X X X     X X   X   X X   X   X X   X   X   X     X X X
X X X X XXXXXXXXX XXX XXX XXXXXXXXXXX X XXXXXXX X X XXX X X XXX XXX X XXXXX X XXX X XXXXX XXXXX X X X
X X X X           X   X   X           X       X X   X X X       X   X X   X X     X   X   X   X X X X
X X XXX XXXXXXXXXXX X X XXX XXXXXXXXXXXXX XXX X XXXXX X X XXXXXXX XXX X X XXXXXXXXXXX X XXX X X XXX X
X X   X X       X   X X   X       X     X X   X X     X X X       X   X X   X         X     X X X   X
X XXX X X XXXXXXX XXXXXXX XXXXXXX X XXX XXX X X XXXXX X X X XXXXXXXXXXX XXX X XXXXXXXXX XXXXX X X X X
X     X X       X       X   X     X X       X X   X   X X X   X   X     X   X     X     X   X   X X X
X XXXXX XXXXXXX XXXXX XXXXX X XXXXX XXXXX XXXXXXX X X X XXXXX X X X XXXXX XXX XXX XXXXX XXX XXXXX XXX
X   X               X     X X     X   X X X     X   X X     X   X   X X   X     X     X       X     X
XXX XXXXXXXXX XXXXX XXXXX X XXXXX XXX X X X X XXXXXXX XXX XXXXXXXXXXX X XXXXXXXXXXXXX XXXXXXX XXX X X
X X X       X X   X X   X X       X X X   X X       X   X X       X   X X             X     X   X X X
X X X XXXXX XXX X XXX X X XXXXXXXXX X XXXXX XXXXXXX XXX X X X XXXXX X X XXX XXXXXXXXXXX XXXXXXX XXX X
X     X         X     X             X             X     X   X       X       X                       K
XXXXXXXXXXXXXXXXXXXXXXXXXXXXXXXXXXXXXXXXXXXXXXXXXXXXXXXXXXXXXXXXXXXXXXXXXXXXXXXXXXXXXXXXXXXXXXXXXXXXX
